"Fragment","Scaffold.ID","Gene.Start","Gene.End","bp.Start","bp.End","Fragment.Length","Category"
"647533937_NZ_DS999412-circular-gene_1745-gene-1810",647533937,1745,1810,1905440,1969070,63630,4
"643348578_NC_011566-gene_2273-gene-2282",643348578,2273,2282,2690277,2700247,9970,4
"2526166977_SER39009_Serratia_39006_draft_12-05-13_1-gene_2589-gene-2649",2526166977,2589,2649,2875756,2917328,41572,4
"2518681435_CP003677-gene_1360-gene-1414",2518681435,1360,1414,1476813,1518304,41491,4
"641522729_NC_010674-gene_2172-gene-2223",641522729,2172,2223,2330638,2362484,31846,4
"641522729_NC_010674-gene_2639-gene-2721",641522729,2639,2721,2821307,2873956,52649,4
"2690318780_Ga0045920_11-gene_2185-gene-2236",2690318780,2185,2236,2331572,2363418,31846,4
"2724812731_K09K1_contig000002-gene_3087-gene-3096",2724812731,3087,3096,3459391,3465668,6277,4
"647010922_NZ_ACZV01000004-circular-gene_818-gene-861",647010922,818,861,929076,962050,32974,5
"2517093774_Syn9616DRAFT_scaffold1_1-circular-gene_431-gene-530",2517093774,431,530,385623,463513,77890,5
"650377989_CP002377-circular-gene_2404-gene-2451",650377989,2404,2451,2595958,2633110,37152,5
"643692038_NC_012440-circular-gene_1738-gene-1798",643692038,1738,1798,1717883,1754803,36920,5
"641381032_NZ_ABGR01000017-circular-gene_2-gene-32",641381032,2,32,744,35872,35128,5
"2540355318_H276DRAFT_scaffold00001_1-circular-gene_733-gene-751",2540355318,733,751,758339,773444,15105,5
"2524708640_K337DRAFT_scaffold00002_2-circular-gene_199-gene-262",2524708640,199,262,216587,263421,46834,5
"2524708640_K337DRAFT_scaffold00002_2-circular-gene_776-gene-848",2524708640,776,848,811492,867042,55550,5
"2516493516_NitteDRAFT_scaffold1_1-circular-gene_1828-gene-1876",2516493516,1828,1876,1757417,1802060,44643,5
"647533937_NZ_DS999412-circular-gene_2641-gene-2698",647533937,2641,2698,2882543,2942386,59843,5
"647533937_NZ_DS999412-circular-gene_3956-gene-3984",647533937,3956,3984,4300099,4322413,22314,5
"647533937_NZ_DS999412-circular-gene_187-gene-234",647533937,187,234,168264,205394,37130,5
"647533937_NZ_DS999412-circular-gene_905-gene-972",647533937,905,972,977246,1027291,50045,5
"647533937_NZ_DS999412-circular-gene_1913-gene-1937",647533937,1913,1937,2073300,2090605,17305,5
"647533937_NZ_DS999412-circular-gene_0-gene-50",647533937,0,50,5013276,30348,-4982928,5
"647533937_NZ_DS999412-circular-gene_4032-gene-4081",647533937,4032,4081,4379596,4410368,30772,5
"2630977684_Ga0081187_11-circular-gene_3910-gene-4007",2630977684,3910,4007,5386966,5505410,118444,5
"646311943_NC_013440-gene_1014-gene-1103",646311943,1014,1103,1278302,1380293,101991,5
"646311943_NC_013440-gene_593-gene-803",646311943,593,803,781640,1031155,249515,5
"650716148_NC_015711-gene_3723-gene-3820",650716148,3723,3820,4307581,4397533,89952,5
"650716148_NC_015711-gene_5117-gene-5198",650716148,5117,5198,5952754,6025098,72344,5
"650716148_NC_015711-gene_7448-gene-7507",650716148,7448,7507,8940043,9002863,62820,5
"2631041750_Ga0081465_101-gene_1388-gene-1486",2631041750,1388,1486,1781102,1884722,103620,5
"637000467_NC_007645-gene_2579-gene-2678",637000467,2579,2678,2918487,2994677,76190,5
"637000467_NC_007645-gene_6132-gene-6174",637000467,6132,6174,6863337,6900524,37187,5
"637000467_NC_007645-gene_4099-gene-4144",637000467,4099,4144,4654311,4691573,37262,5
"637000467_NC_007645-gene_5070-gene-5165",637000467,5070,5165,5730149,5820562,90413,5
"637000467_NC_007645-gene_329-gene-378",637000467,329,378,380499,423375,42876,5
"643692052_NC_012490-gene_2276-gene-2334",643692052,2276,2334,2444253,2488197,43944,5
"643692052_NC_012490-gene_2510-gene-2597",643692052,2510,2597,2668810,2727185,58375,5
"2718228132_Ga0175156_11-gene_1886-gene-2025",2718228132,1886,2025,2063123,2193556,130433,5
"2506485008_Contig317-gene_4573-gene-4589",2506485008,4573,4589,5300854,5314526,13672,5
"2506485008_Contig317-gene_861-gene-960",2506485008,861,960,1008892,1090999,82107,5
"641228507_NC_009997-gene_771-gene-828",641228507,771,828,902045,946782,44737,5
"641228507_NC_009997-gene_2253-gene-2350",641228507,2253,2350,2634975,2726256,91281,5
"641228507_NC_009997-gene_2938-gene-2986",641228507,2938,2986,3439806,3477767,37961,5
"641228507_NC_009997-gene_2143-gene-2194",641228507,2143,2194,2526485,2571522,45037,5
"641228507_NC_009997-gene_2263-gene-2355",641228507,2263,2355,2649580,2731034,81454,5
"2631013058_Ga0046381_11-gene_770-gene-828",2631013058,770,828,900951,945080,44129,5
"2631013058_Ga0046381_11-gene_2879-gene-2918",2631013058,2879,2918,3389466,3420793,31327,5
"2631013058_Ga0046381_11-gene_2102-gene-2153",2631013058,2102,2153,2485996,2531033,45037,5
"651053104_CP002811-gene_1372-gene-1427",651053104,1372,1427,1549973,1586911,36938,5
"651053104_CP002811-gene_3763-gene-3823",651053104,3763,3823,4303951,4352302,48351,5
"651053104_CP002811-gene_2311-gene-2346",651053104,2311,2346,2618435,2646472,28037,5
"640753033_NC_009665-gene_2114-gene-2167",640753033,2114,2167,2481131,2527824,46693,5
"640753033_NC_009665-gene_734-gene-792",640753033,734,792,865059,908266,43207,5
"641522617_NC_010334-gene_1305-gene-1365",641522617,1305,1365,1570540,1619476,48936,5
"2524037964_FO203503-gene_4414-gene-4444",2524037964,4414,4444,5035903,5064438,28535,5
"637000580_NC_008228-gene_681-gene-739",637000580,681,739,774567,826700,52133,5
"2728434717_Ga0175483_11-gene_4890-gene-4960",2728434717,4890,4960,4971246,5032005,60759,5
"2728434717_Ga0175483_11-gene_2299-gene-2331",2728434717,2299,2331,2295307,2324472,29165,5
"2728434717_Ga0175483_11-gene_3929-gene-4004",2728434717,3929,4004,3999581,4061820,62239,5
"643348595_NC_011663-gene_757-gene-814",643348595,757,814,882667,925947,43280,5
"643348595_NC_011663-gene_2594-gene-2664",643348595,2594,2664,3062136,3116455,54319,5
"2507281626_Sbal625_Contig118_1-gene_2046-gene-2094",2507281626,2046,2094,2452419,2497104,44685,5
"2507281626_Sbal625_Contig118_1-gene_2172-gene-2219",2507281626,2172,2219,2588967,2627708,38741,5
"640069332_NC_009052-gene_1283-gene-1342",640069332,1283,1342,1444815,1486320,41505,5
"640069332_NC_009052-gene_3681-gene-3735",640069332,3681,3735,4211115,4254676,43561,5
"640069332_NC_009052-gene_2229-gene-2260",640069332,2229,2260,2519643,2548612,28969,5
"2513256208_cola_cola-finished-ohne-overlap_screen_ace_1_1-gene_1652-gene-1755",2513256208,1652,1755,1921658,2020467,98809,5
"2718228709_Ga0175363_11-gene_1768-gene-1809",2718228709,1768,1809,2261011,2290543,29532,5
"2718228709_Ga0175363_11-gene_986-gene-1083",2718228709,986,1083,1319453,1390860,71407,5
"2561539978_Calab_Cab_131026_1-gene_1768-gene-1809",2561539978,1768,1809,2261011,2290543,29532,5
"2561539978_Calab_Cab_131026_1-gene_986-gene-1083",2561539978,986,1083,1319453,1390860,71407,5
"2643222989_Cab_131026-gene_191-gene-232",2643222989,191,232,237356,266888,29532,5
"2643222989_Cab_131026-gene_3237-gene-3334",2643222989,3237,3334,4274339,4345746,71407,5
"646564597_NC_014012-gene_2007-gene-2037",646564597,2007,2037,2505011,2528729,23718,5
"2526166977_SER39009_Serratia_39006_draft_12-05-13_1-gene_4119-gene-4180",2526166977,4119,4180,4658820,4703210,44390,5
"2526166977_SER39009_Serratia_39006_draft_12-05-13_1-gene_2475-gene-2515",2526166977,2475,2515,2763218,2797702,34484,5
"2524031326_Shewanella-gene_1665-gene-1720",2524031326,1665,1720,1952220,1998477,46257,5
"2619690354_Ga0074067_11-gene_1683-gene-1739",2619690354,1683,1739,1867246,1907731,40485,5
"2619690354_Ga0074067_11-gene_3019-gene-3085",2619690354,3019,3085,3258811,3308244,49433,5
"2619690354_Ga0074067_11-gene_3758-gene-3822",2619690354,3758,3822,4032892,4086706,53814,5
"637000611_NC_008322-gene_717-gene-769",637000611,717,769,819483,855165,35682,5
"644736375_NC_012850-gene_823-gene-861",644736375,823,861,836942,861202,24260,5
"639633068_NC_008576-gene_2853-gene-3064",639633068,2853,3064,3450321,3618086,167765,5
"639633068_NC_008576-gene_2665-gene-2747",639633068,2665,2747,3230037,3315977,85940,5
"639633068_NC_008576-gene_1792-gene-1805",639633068,1792,1805,2118243,2128708,10465,5
"639633068_NC_008576-gene_1761-gene-1772",639633068,1761,1772,2086351,2095198,8847,5
"639633068_NC_008576-gene_2092-gene-2188",639633068,2092,2188,2482937,2569493,86556,5
"639633068_NC_008576-gene_1292-gene-1425",639633068,1292,1425,1527944,1634506,106562,5
"650716032_NC_015275-gene_951-gene-1022",650716032,951,1022,1097422,1137768,40346,5
"650716032_NC_015275-gene_2749-gene-2844",650716032,2749,2844,2984437,3049840,65403,5
"650716032_NC_015275-gene_735-gene-900",650716032,735,900,914850,1048086,133236,5
"650716032_NC_015275-gene_1198-gene-1217",650716032,1198,1217,1347441,1365519,18078,5
"650716032_NC_015275-gene_1849-gene-1912",650716032,1849,1912,2051269,2090332,39063,5
"639633107_NC_008750-gene_2904-gene-2975",639633107,2904,2975,3308788,3365148,56360,5
"639633107_NC_008750-gene_2480-gene-2560",639633107,2480,2560,2832008,2887378,55370,5
"2506213072_Contig398-gene_1804-gene-1865",2506213072,1804,1865,2005664,2053485,47821,5
"2506213072_Contig398-gene_4176-gene-4195",2506213072,4176,4195,4652481,4664967,12486,5
"2524031327_Shewanella-gene_3320-gene-3369",2524031327,3320,3369,3865190,3906314,41124,5
"2517487235_scaffold00006-gene_2294-gene-2391",2517487235,2294,2391,2349298,2426553,77255,5
"2521194441_CP003845-gene_2449-gene-2500",2521194441,2449,2500,2891581,2933581,42000,5
"650377919_CP001978-gene_1950-gene-2018",650377919,1950,2018,2063045,2110993,47948,5
"650377919_CP001978-gene_644-gene-703",650377919,644,703,671039,712504,41465,5
"642555224_NC_011138-gene_754-gene-825",642555224,754,825,834034,889750,55716,5
"2597512639_Ga0036914_gi564132530_1-gene_2218-gene-2230",2597512639,2218,2230,2399994,2408175,8181,5
"2597512639_Ga0036914_gi564132530_1-gene_1146-gene-1179",2597512639,1146,1179,1238745,1276442,37697,5
"2721800935_Ga0175699_12-gene_2062-gene-2159",2721800935,2062,2159,2138964,2233801,94837,5
"2721800935_Ga0175699_12-gene_1067-gene-1088",2721800935,1067,1088,1126960,1143473,16513,5
"2521191523_Phaar_neu_scaffold_2516677464_1-gene_2113-gene-2204",2521191523,2113,2204,2203286,2280615,77329,5
"2521191523_Phaar_neu_scaffold_2516677464_1-gene_2017-gene-2055",2521191523,2017,2055,2116226,2145392,29166,5
"2521191523_Phaar_neu_scaffold_2516677464_1-gene_1-gene-82",2521191523,1,82,0,63298,63298,5
"2521191523_Phaar_neu_scaffold_2516677464_1-gene_1517-gene-1561",2521191523,1517,1561,1606892,1639329,32437,5
"2512569605_Leime_Contig76_3-gene_3039-gene-3094",2512569605,3039,3094,3066207,3120558,54351,5
"2512569605_Leime_Contig76_3-gene_1289-gene-1357",2512569605,1289,1357,1295144,1343567,48423,5
"2512569605_Leime_Contig76_3-gene_1786-gene-1861",2512569605,1786,1861,1791364,1854045,62681,5
"2512569605_Leime_Contig76_3-gene_2139-gene-2184",2512569605,2139,2184,2141757,2177757,36000,5
"2687454401_Ga0133388_11-gene_2032-gene-2128",2687454401,2032,2128,2114360,2195720,81360,5
"2687454401_Ga0133388_11-gene_2609-gene-2695",2687454401,2609,2695,2734000,2804434,70434,5
"2687454401_Ga0133388_11-gene_3574-gene-3699",2687454401,3574,3699,3767093,3867276,100183,5
"2667542047_Ga0105927_11-gene_3574-gene-3693",2667542047,3574,3693,3771957,3868806,96849,5
"2667542047_Ga0105927_11-gene_2041-gene-2135",2667542047,2041,2135,2118291,2199626,81335,5
"2667542047_Ga0105927_11-gene_2614-gene-2700",2667542047,2614,2700,2737904,2808661,70757,5
"2622780072_scf7180000000004-gene_1974-gene-2063",2622780072,1974,2063,2351852,2430539,78687,5
"637000159_NC_003911-gene_1040-gene-1075",637000159,1040,1075,1080764,1105118,24354,5
"2558913391_P176DRAFT_scf7180000000002_quiver_dupTrim_6579_1-gene_2375-gene-2437",2558913391,2375,2437,2766915,2814914,47999,5
"637000312_NC_006370-gene_1312-gene-1372",637000312,1312,1372,1478766,1530840,52074,5
"646564576_NC_013960-gene_932-gene-1037",646564576,932,1037,954143,1034729,80586,5
"2512205695_CP002987-gene_3566-gene-3646",2512205695,3566,3646,3955988,4009903,53915,5
"2512205695_CP002987-gene_3164-gene-3224",2512205695,3164,3224,3568170,3601737,33567,5
"2667542034_Ga0114080_11-gene_2641-gene-2706",2667542034,2641,2706,2266564,2311513,44949,5
"2511244427_NC_016078-gene_672-gene-732",2511244427,672,732,676603,719639,43036,5
"2511244427_NC_016078-gene_909-gene-925",2511244427,909,925,916135,932318,16183,5
"2667541935_Ga0102658_12-gene_1305-gene-1353",2667541935,1305,1353,1485562,1523601,38039,5
"2597520218_Ga0032872_gi461490773_1-gene_433-gene-485",2597520218,433,485,506714,542314,35600,5
"647533601_NZ_DS995281-gene_3189-gene-3242",647533601,3189,3242,3275278,3337031,61753,5
"2645768409_Ga0069294_12-gene_1623-gene-1688",2645768409,1623,1688,1857872,1898581,40709,5
"650716102_NC_015590-gene_229-gene-295",650716102,229,295,264429,314278,49849,5
"650716102_NC_015590-gene_1342-gene-1435",650716102,1342,1435,1377451,1449441,71990,5
"650716102_NC_015590-gene_1805-gene-1848",650716102,1805,1848,1841924,1873068,31144,5
"650716102_NC_015590-gene_750-gene-840",650716102,750,840,790860,851832,60972,5
"650716102_NC_015590-gene_2233-gene-2317",650716102,2233,2317,2288740,2355208,66468,5
"641522729_NC_010674-gene_862-gene-917",641522729,862,917,935466,973377,37911,5
"641522729_NC_010674-gene_1816-gene-1896",641522729,1816,1896,1979655,2030044,50389,5
"641522729_NC_010674-gene_2305-gene-2328",641522729,2305,2328,2463246,2483517,20271,5
"639633066_NC_008571-gene_2228-gene-2314",639633066,2228,2314,2547178,2605024,57846,5
"647533810_NZ_DS999213-gene_3456-gene-3479",647533810,3456,3479,3580544,3600594,20050,5
"2690318780_Ga0045920_11-gene_868-gene-923",2690318780,868,923,936395,974306,37911,5
"2690318780_Ga0045920_11-gene_1827-gene-1921",2690318780,1827,1921,1980589,2046533,65944,5
"2690318780_Ga0045920_11-gene_2646-gene-2739",2690318780,2646,2739,2813381,2874917,61536,5
"2690318780_Ga0045920_11-gene_2318-gene-2341",2690318780,2318,2341,2464182,2484453,20271,5
"640753071_NC_009783-gene_1750-gene-1832",640753071,1750,1832,1945668,2014249,68581,5
"640753071_NC_009783-gene_2103-gene-2124",640753071,2103,2124,2305531,2320928,15397,5
"2561541728_CP006605-gene_366-gene-387",2561541728,366,387,410068,425465,15397,5
"2561541728_CP006605-gene_664-gene-745",2561541728,664,745,715573,784101,68528,5
"637000620_NC_008358-gene_2448-gene-2531",637000620,2448,2531,2600270,2709098,108828,5
"2648578723_Ga0045936_12-gene_1323-gene-1352",2648578723,1323,1352,1515663,1536111,20448,5
"2648578723_Ga0045936_12-gene_2016-gene-2109",2648578723,2016,2109,2296214,2377697,81483,5
"2540348203_FO203427-gene_2262-gene-2352",2540348203,2262,2352,2477813,2569803,91990,5
"647533454_NZ_DS989898-gene_1834-gene-1925",647533454,1834,1925,1883599,1963726,80127,5
"637000323_NC_006510-gene_498-gene-574",637000323,498,574,538104,581745,43641,5
"646311903_NC_013222-gene_2691-gene-2741",646311903,2691,2741,3087155,3128656,41501,5
"637000284_NC_006138-gene_1537-gene-1593",637000284,1537,1593,1735086,1787735,52649,5
"637000284_NC_006138-gene_1986-gene-2086",637000284,1986,2086,2255392,2373762,118370,5
"2512211939_PhacaeDRAFT_Scaffold1_6-gene_3366-gene-3405",2512211939,3366,3405,3496131,3520745,24614,5
"2512211939_PhacaeDRAFT_Scaffold1_6-gene_1-gene-35",2512211939,1,35,0,21245,21245,5
"2512211939_PhacaeDRAFT_Scaffold1_6-gene_2735-gene-2790",2512211939,2735,2790,2857205,2898302,41097,5
"2724812732_K10K4_chromosome1-gene_1532-gene-1548",2724812732,1532,1548,1701740,1711489,9749,5
"2724812732_K10K4_chromosome1-gene_1209-gene-1253",2724812732,1209,1253,1355664,1393405,37741,5
"2724812413_K04M3_chromosome1-gene_1209-gene-1253",2724812413,1209,1253,1355665,1393406,37741,5
"2724812419_K05K4_chromosome1-gene_1557-gene-1573",2724812419,1557,1573,1718183,1727552,9369,5
"2724812419_K05K4_chromosome1-gene_1231-gene-1275",2724812419,1231,1275,1372107,1409848,37741,5
"2724812408_K04M1_chromosome1-gene_1240-gene-1284",2724812408,1240,1284,1377940,1415681,37741,5
"2724812723_K06K5_chromosome1-gene_1241-gene-1285",2724812723,1241,1285,1377416,1415157,37741,5
"2724812416_K04M5_chromosome1-gene_1207-gene-1251",2724812416,1207,1251,1355665,1393406,37741,5
"2724812406_K01M1_chromosome1-gene_1233-gene-1277",2724812406,1233,1277,1374410,1412151,37741,5
"2724812734_K08M3_chromosome1-gene_1230-gene-1274",2724812734,1230,1274,1372951,1410692,37741,5
"2724812731_K09K1_contig000002-gene_302-gene-346",2724812731,302,346,319923,357665,37742,5
"2724812731_K09K1_contig000002-gene_1-gene-22",2724812731,1,22,415,11584,11169,5
"2718228555_Ga0175862_11-gene_3168-gene-3266",2718228555,3168,3266,3222652,3327670,105018,5
"2718228555_Ga0175862_11-gene_3274-gene-3361",2718228555,3274,3361,3337144,3428222,91078,5
"2718228555_Ga0175862_11-gene_1409-gene-1459",2718228555,1409,1459,1405091,1454648,49557,5
"2718227896_Ga0175494_11-gene_2146-gene-2191",2718227896,2146,2191,2589586,2628299,38713,5
"2627905620_Ga0077997_11-gene_2472-gene-2532",2627905620,2472,2532,2479605,2523479,43874,5
"642555204_NC_011026-gene_256-gene-282",642555204,256,282,303948,325903,21955,5
"2549075848_RCA23c-gene_2282-gene-2353",2549075848,2282,2353,2370338,2440463,70125,5
"646311952_NC_013456-gene_1805-gene-1819",646311952,1805,1819,2033154,2046026,12872,5
"637000417_NC_007481-gene_1433-gene-1478",637000417,1433,1478,1587400,1623178,35778,5
"643348691_NC_011963-gene_2988-gene-3036",643348691,2988,3036,3078658,3117660,39002,5
"643348691_NC_011963-gene_323-gene-394",643348691,323,394,325768,378487,52719,5
"2718228560_Ga0175864_11-gene_679-gene-734",2718228560,679,734,786863,827832,40969,5
"2627853750_Ga0079189_11-gene_2309-gene-2332",2627853750,2309,2332,2407663,2423005,15342,5
"2627853750_Ga0079189_11-gene_1059-gene-1101",2627853750,1059,1101,1103948,1128199,24251,5
"2627853750_Ga0079189_11-gene_2109-gene-2159",2627853750,2109,2159,2205281,2241253,35972,5
"2627853750_Ga0079189_11-gene_2747-gene-2783",2627853750,2747,2783,2877000,2902278,25278,5
"2627853750_Ga0079189_11-gene_728-gene-784",2627853750,728,784,764742,804560,39818,5
"2627853750_Ga0079189_11-gene_2403-gene-2446",2627853750,2403,2446,2506820,2537239,30419,5
"2627853750_Ga0079189_11-gene_1309-gene-1413",2627853750,1309,1413,1352277,1437697,85420,5
"2627853750_Ga0079189_11-gene_829-gene-894",2627853750,829,894,857046,917003,59957,5
"647535429_NZ_GG704599-gene_2480-gene-2540",647535429,2480,2540,2530324,2587246,56922,5
"649633102_NC_014831-gene_17-gene-67",649633102,17,67,19306,59135,39829,5
"647533516_NZ_DS990556-gene_1296-gene-1378",647533516,1296,1378,1284195,1355092,70897,5
"647533516_NZ_DS990556-gene_624-gene-664",647533516,624,664,616306,656141,39835,5
"2507267694_KS100_Contig_1-gene_2693-gene-2762",2507267694,2693,2762,2613864,2685797,71933,5
"2507267694_KS100_Contig_1-gene_203-gene-232",2507267694,203,232,226877,254576,27699,5
"2507267694_KS100_Contig_1-gene_2020-gene-2084",2507267694,2020,2084,1950549,2008165,57616,5
"646564595_NC_014010-gene_2295-gene-2316",646564595,2295,2316,2466286,2484416,18130,5
"646564595_NC_014010-gene_370-gene-416",646564595,370,416,384275,428636,44361,5
"2718229246_Ga0175211_11-gene_2496-gene-2531",2718229246,2496,2531,2527993,2547486,19493,5
"2718229246_Ga0175211_11-gene_1632-gene-1696",2718229246,1632,1696,1677150,1717632,40482,5
"2571071633_BS76DRAFT_scf7180000000002_quiver_dupTrim_10022_1-gene_509-gene-575",2571071633,509,575,529035,577899,48864,5
"2718228072_Ga0174827_11-gene_1031-gene-1050",2718228072,1031,1050,1110568,1127528,16960,5
"637000441_NC_007516-gene_539-gene-587",637000441,539,587,516757,552640,35883,5
"637000441_NC_007516-gene_1761-gene-1851",637000441,1761,1851,1548638,1609705,61067,5
"2571156966_P166DRAFT_scf7180000000008_quiver_2-gene_408-gene-460",2571156966,408,460,451582,487311,35729,5
"2675923119_Ga0104434_115-circular-gene_43-gene-152",2675923119,43,152,27608,123395,95787,6
"2515169221_B108DRAFT_scaffold_25_26-circular-gene_3-gene-14",2515169221,3,14,1960,16733,14773,6
"2524663017_G410DRAFT_scaffold00003_3-circular-gene_442-gene-469",2524663017,442,469,441096,230,-440866,6
"2588286426_JAMC01000014-circular-gene_3-gene-18",2588286426,3,18,890,15358,14468,6
"2627929999_Ga0072914_123-circular-gene_1-gene-17",2627929999,1,17,128,9898,9770,6
"2517093774_Syn9616DRAFT_scaffold1_1-circular-gene_2737-gene-2781",2517093774,2737,2781,2615499,2645261,29762,6
"2517093774_Syn9616DRAFT_scaffold1_1-circular-gene_6-gene-37",2517093774,6,37,5336,27908,22572,6
"2517093774_Syn9616DRAFT_scaffold1_1-circular-gene_1000-gene-1097",2517093774,1000,1097,933842,1006510,72668,6
"2517093774_Syn9616DRAFT_scaffold1_1-circular-gene_1105-gene-1199",2517093774,1105,1199,1013501,1072615,59114,6
"2517093774_Syn9616DRAFT_scaffold1_1-circular-gene_831-gene-853",2517093774,831,853,779187,793750,14563,6
"647533410_NZ_DS989854-circular-gene_108-gene-136",647533410,108,136,167050,197637,30587,6
"647533410_NZ_DS989854-circular-gene_1-gene-86",647533410,1,86,0,121490,121490,6
"2585503063_EJ41DRAFT_scaffold00022_22-circular-gene_11-gene-33",2585503063,11,33,6648,27630,20982,6
"2519109854_F550DRAFT_scaffold00001_1-circular-gene_2034-gene-2059",2519109854,2034,2059,2094654,2116558,21904,6
"2537605091_AODW01000026-circular-gene_76-gene-93",2537605091,76,93,73462,85457,11995,6
"2519942254_C505DRAFT_scaffold00018_18-circular-gene_25-gene-80",2519942254,25,80,25826,64448,38622,6
"2540355318_H276DRAFT_scaffold00001_1-circular-gene_3183-gene-3282",2540355318,3183,3282,3321195,3425231,104036,6
"2630977689_Ga0081190_11-gene_6748-gene-6761",2630977689,6748,6761,9544825,9557968,13143,6
"2630977689_Ga0081190_11-gene_4539-gene-4628",2630977689,4539,4628,6482882,6583593,100711,6
"2630977689_Ga0081190_11-gene_4792-gene-4891",2630977689,4792,4891,6828725,6968914,140189,6
"2630977689_Ga0081190_11-gene_827-gene-924",2630977689,827,924,1110493,1247883,137390,6
"2630977689_Ga0081190_11-gene_2458-gene-2533",2630977689,2458,2533,3430431,3541910,111479,6
"2524708640_K337DRAFT_scaffold00002_2-circular-gene_452-gene-550",2524708640,452,550,462969,552693,89724,6
"2523241327_G578DRAFT_scaffold00006_6-circular-gene_57-gene-74",2523241327,57,74,48651,61595,12944,6
"647533937_NZ_DS999412-circular-gene_3605-gene-3702",647533937,3605,3702,3939838,4028861,89023,6
"2551322073_A132DRAFT_AJYX01000047_1_47-circular-gene_8-gene-29",2551322073,8,29,9838,30399,20561,6
"2630977684_Ga0081187_11-circular-gene_5613-gene-5707",2630977684,5613,5707,7606015,7719752,113737,6
"2630977684_Ga0081187_11-circular-gene_1095-gene-1216",2630977684,1095,1216,1487507,1631054,143547,6
"2630977684_Ga0081187_11-circular-gene_2685-gene-2781",2630977684,2685,2781,3623370,3752077,128707,6
"2630977684_Ga0081187_11-circular-gene_4673-gene-4725",2630977684,4673,4725,6375942,6425443,49501,6
"2630977684_Ga0081187_11-circular-gene_2415-gene-2490",2630977684,2415,2490,3240842,3331029,90187,6
"2630977684_Ga0081187_11-circular-gene_828-gene-924",2630977684,828,924,1106606,1234076,127470,6
"2630977684_Ga0081187_11-circular-gene_6413-gene-6428",2630977684,6413,6428,8680596,8693336,12740,6
"2718228070_Ga0174825_11-gene_5539-gene-5638",2718228070,5539,5638,7799776,7939965,140189,6
"2718228070_Ga0174825_11-gene_5802-gene-5891",2718228070,5802,5891,8185097,8285808,100711,6
"2718228070_Ga0174825_11-gene_1046-gene-1120",2718228070,1046,1120,1553672,1665151,111479,6
"2718228070_Ga0174825_11-gene_2654-gene-2751",2718228070,2654,2751,3847699,3985089,137390,6
"2718228070_Ga0174825_11-gene_3669-gene-3682",2718228070,3669,3682,5210722,5223865,13143,6
"646311943_NC_013440-gene_873-gene-992",646311943,873,992,1121299,1241803,120504,6
"646311943_NC_013440-gene_1566-gene-1665",646311943,1566,1665,2096300,2228050,131750,6
"646311943_NC_013440-gene_6459-gene-6512",646311943,6459,6512,8712981,8786032,73051,6
"646311943_NC_013440-gene_2885-gene-2983",646311943,2885,2983,3901505,4011359,109854,6
"646311943_NC_013440-gene_1131-gene-1193",646311943,1131,1193,1429988,1494345,64357,6
"646311943_NC_013440-gene_1223-gene-1298",646311943,1223,1298,1559422,1674167,114745,6
"646311943_NC_013440-gene_2613-gene-2694",646311943,2613,2694,3574267,3674500,100233,6
"646311943_NC_013440-gene_3076-gene-3172",646311943,3076,3172,4195889,4313830,117941,6
"650716148_NC_015711-gene_1881-gene-2147",650716148,1881,2147,2205341,2511960,306619,6
"650716148_NC_015711-gene_3139-gene-3236",650716148,3139,3236,3634976,3741271,106295,6
"650716148_NC_015711-gene_1364-gene-1462",650716148,1364,1462,1605066,1718126,113060,6
"650716148_NC_015711-gene_878-gene-992",650716148,878,992,1045169,1174972,129803,6
"2631041829_Ga0081470_101-gene_4803-gene-4899",2631041829,4803,4899,6180476,6301592,121116,6
"2631041829_Ga0081470_101-gene_874-gene-970",2631041829,874,970,1109040,1224964,115924,6
"2631041829_Ga0081470_101-gene_3753-gene-3813",2631041829,3753,3813,4856722,4924358,67636,6
"2631041750_Ga0081465_101-gene_2206-gene-2295",2631041750,2206,2295,2863666,2956141,92475,6
"2631041750_Ga0081465_101-gene_3177-gene-3262",2631041750,3177,3262,4106562,4227524,120962,6
"2631041750_Ga0081465_101-gene_1867-gene-1926",2631041750,1867,1926,2396611,2467466,70855,6
"2631041750_Ga0081465_101-gene_4134-gene-4229",2631041750,4134,4229,5349319,5453043,103724,6
"637000606_NC_008312-gene_4078-gene-4123",637000606,4078,4123,6533157,6576535,43378,6
"637000606_NC_008312-gene_1286-gene-1382",637000606,1286,1382,2106565,2242912,136347,6
"637000606_NC_008312-gene_3386-gene-3484",637000606,3386,3484,5405655,5544111,138456,6
"637000606_NC_008312-gene_2943-gene-3042",637000606,2943,3042,4713202,4829141,115939,6
"637000606_NC_008312-gene_1114-gene-1208",637000606,1114,1208,1849434,1966962,117528,6
"637000606_NC_008312-gene_282-gene-299",637000606,282,299,470714,475205,4491,6
"637000606_NC_008312-gene_4711-gene-4800",637000606,4711,4800,7446415,7529688,83273,6
"637000467_NC_007645-gene_3517-gene-3550",637000467,3517,3550,4015384,4055166,39782,6
"637000467_NC_007645-gene_3387-gene-3472",637000467,3387,3472,3866134,3953635,87501,6
"637000467_NC_007645-gene_3236-gene-3309",637000467,3236,3309,3698631,3771374,72743,6
"637000467_NC_007645-gene_6362-gene-6418",637000467,6362,6418,7115730,7187335,71605,6
"637000467_NC_007645-gene_2880-gene-2978",637000467,2880,2978,3242227,3356516,114289,6
"637000233_NC_005027-gene_1561-gene-1633",637000233,1561,1633,2156629,2242457,85828,6
"637000233_NC_005027-gene_4489-gene-4588",637000233,4489,4588,6130429,6236992,106563,6
"637000233_NC_005027-gene_1-gene-28",637000233,1,28,0,30326,30326,6
"650716066_NC_015434-gene_2221-gene-2325",650716066,2221,2325,2371225,2477888,106663,6
"650716066_NC_015434-gene_579-gene-663",650716066,579,663,605894,696261,90367,6
"650716066_NC_015434-gene_2471-gene-2528",650716066,2471,2528,2660767,2707994,47227,6
"650716066_NC_015434-gene_5848-gene-5939",650716066,5848,5939,6415347,6529768,114421,6
"643692052_NC_012490-gene_2927-gene-2959",643692052,2927,2959,3072397,3097283,24886,6
"643692052_NC_012490-gene_2081-gene-2105",643692052,2081,2105,2239896,2260962,21066,6
"2508527215_MycrhN_Contig54_1-gene_2757-gene-2855",2508527215,2757,2855,2801592,2893013,91421,6
"2506535018_Aquba_Contig381-gene_3222-gene-3322",2506535018,3222,3322,3969746,4076128,106382,6
"2506535018_Aquba_Contig381-gene_4305-gene-4334",2506535018,4305,4334,5294383,5330093,35710,6
"2506535018_Aquba_Contig381-gene_2596-gene-2688",2506535018,2596,2688,3153720,3263775,110055,6
"2508501807_SacmaDRAFT_SMG_1-gene_13-gene-105",2508501807,13,105,15093,98516,83423,6
"2508501807_SacmaDRAFT_SMG_1-gene_5225-gene-5315",2508501807,5225,5315,5423726,5508304,84578,6
"2508501807_SacmaDRAFT_SMG_1-gene_4114-gene-4201",2508501807,4114,4201,4276285,4357716,81431,6
"2718228132_Ga0175156_11-gene_4007-gene-4032",2718228132,4007,4032,4352449,4372994,20545,6
"2506485008_Contig317-gene_2764-gene-2782",2506485008,2764,2782,3233670,3246034,12364,6
"2506485008_Contig317-gene_4705-gene-4893",2506485008,4705,4893,5443873,5698227,254354,6
"643692025_NC_012108-gene_1861-gene-1913",643692025,1861,1913,2163671,2214118,50447,6
"643692025_NC_012108-gene_4277-gene-4332",643692025,4277,4332,4977214,5033916,56702,6
"2562628756_CP007203-gene_1941-gene-1987",2562628756,1941,1987,2212462,2247794,35332,6
"643348578_NC_011566-gene_2857-gene-2879",643348578,2857,2879,3378505,3397747,19242,6
"637000158_NC_003910-gene_774-gene-798",637000158,774,798,887208,903063,15855,6
"637000158_NC_003910-gene_303-gene-340",637000158,303,340,350248,386593,36345,6
"651053104_CP002811-gene_183-gene-227",651053104,183,227,212067,254198,42131,6
"2512564983_OA238_c-gene_4348-gene-4433",2512564983,4348,4433,4048829,4116476,67647,6
"2524037964_FO203503-gene_3169-gene-3261",2524037964,3169,3261,3567366,3644024,76658,6
"2728434717_Ga0175483_11-gene_825-gene-914",2728434717,825,914,816091,870732,54641,6
"2728434717_Ga0175483_11-gene_4310-gene-4351",2728434717,4310,4351,4389037,4425797,36760,6
"646564612_NC_014041-gene_2018-gene-2041",646564612,2018,2041,2324446,2342794,18348,6
"646564612_NC_014041-gene_3681-gene-3766",646564612,3681,3766,4256332,4324707,68375,6
"646564612_NC_014041-gene_3035-gene-3124",646564612,3035,3124,3542923,3622144,79221,6
"646564612_NC_014041-gene_1172-gene-1265",646564612,1172,1265,1365365,1457088,91723,6
"646564612_NC_014041-gene_2481-gene-2503",646564612,2481,2503,2867548,2879201,11653,6
"637000514_NC_007912-gene_1863-gene-1895",637000514,1863,1895,2300286,2326857,26571,6
"637000514_NC_007912-gene_3099-gene-3115",637000514,3099,3115,3836046,3846111,10065,6
"637000514_NC_007912-gene_2363-gene-2423",637000514,2363,2423,2926621,2977451,50830,6
"637000514_NC_007912-gene_434-gene-492",637000514,434,492,518134,568078,49944,6
"2504762402_Contig38-gene_2938-gene-2958",2504762402,2938,2958,3281385,3294342,12957,6
"2504762402_Contig38-gene_1644-gene-1740",2504762402,1644,1740,1852324,1946237,93913,6
"2513256208_cola_cola-finished-ohne-overlap_screen_ace_1_1-gene_3380-gene-3408",2513256208,3380,3408,4004210,4026923,22713,6
"2513256208_cola_cola-finished-ohne-overlap_screen_ace_1_1-gene_2454-gene-2545",2513256208,2454,2545,2868388,2976331,107943,6
"2513256208_cola_cola-finished-ohne-overlap_screen_ace_1_1-gene_725-gene-777",2513256208,725,777,894485,949248,54763,6
"2513256208_cola_cola-finished-ohne-overlap_screen_ace_1_1-gene_1922-gene-1992",2513256208,1922,1992,2230294,2285331,55037,6
"2513256208_cola_cola-finished-ohne-overlap_screen_ace_1_1-gene_1839-gene-1896",2513256208,1839,1896,2125681,2190492,64811,6
"2513256208_cola_cola-finished-ohne-overlap_screen_ace_1_1-gene_2288-gene-2356",2513256208,2288,2356,2662208,2736198,73990,6
"2513256208_cola_cola-finished-ohne-overlap_screen_ace_1_1-gene_1353-gene-1442",2513256208,1353,1442,1596454,1680431,83977,6
"2513256208_cola_cola-finished-ohne-overlap_screen_ace_1_1-gene_3978-gene-4033",2513256208,3978,4033,4695011,4750386,55375,6
"2718228709_Ga0175363_11-gene_1456-gene-1505",2718228709,1456,1505,1880414,1934299,53885,6
"2561539978_Calab_Cab_131026_1-gene_1456-gene-1505",2561539978,1456,1505,1880414,1934299,53885,6
"2643222989_Cab_131026-gene_3707-gene-3756",2643222989,3707,3756,4835300,4889185,53885,6
"2504404809_AMB_SN2-gene_1202-gene-1245",2504404809,1202,1245,1419056,1449472,30416,6
"2504404809_AMB_SN2-gene_3425-gene-3481",2504404809,3425,3481,3959204,4000086,40882,6
"2504404809_AMB_SN2-gene_2113-gene-2134",2504404809,2113,2134,2440803,2457795,16992,6
"2521194451_CP003466-gene_2064-gene-2140",2521194451,2064,2140,2267143,2344440,77297,6
"2554309016_CP006643-gene_4315-gene-4342",2554309016,4315,4342,4319696,4349081,29385,6
"2526166614_K365DRAFT_scaffold00001_1-gene_2939-gene-3028",2526166614,2939,3028,3144735,3211291,66556,6
"2526166614_K365DRAFT_scaffold00001_1-gene_2054-gene-2120",2526166614,2054,2120,2182760,2237229,54469,6
"2526166614_K365DRAFT_scaffold00001_1-gene_70-gene-137",2526166614,70,137,75641,124136,48495,6
"2526166614_K365DRAFT_scaffold00001_1-gene_1819-gene-1840",2526166614,1819,1840,1908163,1923456,15293,6
"637000611_NC_008322-gene_1040-gene-1074",637000611,1040,1074,1173198,1208295,35097,6
"639633068_NC_008576-gene_2295-gene-2394",639633068,2295,2394,2788052,2908490,120438,6
"650716032_NC_015275-gene_3744-gene-3816",650716032,3744,3816,4059134,4134696,75562,6
"650716032_NC_015275-gene_1500-gene-1529",650716032,1500,1529,1668325,1688261,19936,6
"2596658995_LX98DRAFT_unitig_0_quiver_1-gene_1357-gene-1455",2596658995,1357,1455,1600434,1709881,109447,6
"2596658995_LX98DRAFT_unitig_0_quiver_1-gene_923-gene-1015",2596658995,923,1015,1076589,1190087,113498,6
"2684693078_Ga0125241_11-gene_2209-gene-2245",2684693078,2209,2245,2643101,2667259,24158,6
"2718228273_Ga0174870_11-gene_1093-gene-1155",2718228273,1093,1155,1240194,1315681,75487,6
"2718228273_Ga0174870_11-gene_2263-gene-2345",2718228273,2263,2345,2653856,2732450,78594,6
"639633099_NC_008711-gene_3189-gene-3244",639633099,3189,3244,3459694,3520334,60640,6
"639633098_NC_008709-gene_2610-gene-2648",639633098,2610,2648,3123636,3169177,45541,6
"2524031327_Shewanella-gene_142-gene-160",2524031327,142,160,150457,169260,18803,6
"2517487235_scaffold00006-gene_2798-gene-2848",2517487235,2798,2848,2825633,2870622,44989,6
"2517487235_scaffold00006-gene_2686-gene-2731",2517487235,2686,2731,2714027,2761266,47239,6
"649633075_NC_014759-gene_3428-gene-3459",649633075,3428,3459,4114967,4150955,35988,6
"649633075_NC_014759-gene_1905-gene-1964",649633075,1905,1964,2330185,2392416,62231,6
"2521194441_CP003845-gene_2019-gene-2052",2521194441,2019,2052,2399118,2422966,23848,6
"637000589_NC_008255-gene_2191-gene-2290",637000589,2191,2290,2656102,2751587,95485,6
"637000589_NC_008255-gene_477-gene-539",637000589,477,539,578980,654530,75550,6
"637000589_NC_008255-gene_2821-gene-2849",637000589,2821,2849,3365689,3400262,34573,6
"650377919_CP001978-gene_3109-gene-3128",650377919,3109,3128,3247572,3262409,14837,6
"650377919_CP001978-gene_69-gene-168",650377919,69,168,77394,163909,86515,6
"642555224_NC_011138-gene_3586-gene-3618",642555224,3586,3618,4042153,4065027,22874,6
"2597512639_Ga0036914_gi564132530_1-gene_1826-gene-1849",2597512639,1826,1849,1967982,1989439,21457,6
"2597512639_Ga0036914_gi564132530_1-gene_3202-gene-3264",2597512639,3202,3264,3458987,3519090,60103,6
"2597512639_Ga0036914_gi564132530_1-gene_3097-gene-3192",2597512639,3097,3192,3356791,3445787,88996,6
"2721801484_Ga0175998_12-gene_465-gene-503",2721801484,465,503,549093,572064,22971,6
"2721801484_Ga0175998_12-gene_2983-gene-3022",2721801484,2983,3022,3567570,3606413,38843,6
"2512571803_NC_016940-gene_493-gene-534",2512571803,493,534,647889,697810,49921,6
"2512571803_NC_016940-gene_2600-gene-2706",2512571803,2600,2706,3333163,3468740,135577,6
"2512571803_NC_016940-gene_3144-gene-3226",2512571803,3144,3226,4010366,4123157,112791,6
"2512571803_NC_016940-gene_112-gene-205",2512571803,112,205,135529,267910,132381,6
"2512571803_NC_016940-gene_270-gene-366",2512571803,270,366,350324,502287,151963,6
"2512571803_NC_016940-gene_3304-gene-3403",2512571803,3304,3403,4233049,4340705,107656,6
"2512571803_NC_016940-gene_2711-gene-2913",2512571803,2711,2913,3474918,3717888,242970,6
"2721800935_Ga0175699_12-gene_4069-gene-4106",2721800935,4069,4106,4182293,4208946,26653,6
"2721800935_Ga0175699_12-gene_1265-gene-1339",2721800935,1265,1339,1329404,1389445,60041,6
"2721800935_Ga0175699_12-gene_3788-gene-3885",2721800935,3788,3885,3888197,3986037,97840,6
"2519117607_CP003746-gene_2821-gene-2874",2519117607,2821,2874,3043185,3079999,36814,6
"2521191523_Phaar_neu_scaffold_2516677464_1-gene_4099-gene-4114",2521191523,4099,4114,4207554,4215395,7841,6
"2521191523_Phaar_neu_scaffold_2516677464_1-gene_2349-gene-2393",2521191523,2349,2393,2442235,2474606,32371,6
"2687454401_Ga0133388_11-gene_3422-gene-3469",2687454401,3422,3469,3588492,3653324,64832,6
"2687454401_Ga0133388_11-gene_397-gene-493",2687454401,397,493,408818,495851,87033,6
"2667542047_Ga0105927_11-gene_3426-gene-3470",2667542047,3426,3470,3595323,3658705,63382,6
"2667542047_Ga0105927_11-gene_397-gene-496",2667542047,397,496,408817,498133,89316,6
"2622780072_scf7180000000004-gene_1460-gene-1474",2622780072,1460,1474,1722181,1727364,5183,6
"2558913391_P176DRAFT_scf7180000000002_quiver_dupTrim_6579_1-gene_1705-gene-1719",2558913391,1705,1719,1998637,2008375,9738,6
"2558913391_P176DRAFT_scf7180000000002_quiver_dupTrim_6579_1-gene_3514-gene-3571",2558913391,3514,3571,4077182,4106062,28880,6
"2558913391_P176DRAFT_scf7180000000002_quiver_dupTrim_6579_1-gene_211-gene-301",2558913391,211,301,236523,342458,105935,6
"2718228355_Ga0175168_11-gene_1545-gene-1628",2718228355,1545,1628,1786061,1859443,73382,6
"2506842939_Thimo_Contig50-gene_2222-gene-2287",2506842939,2222,2287,2495885,2560905,65020,6
"2506842939_Thimo_Contig50-gene_758-gene-820",2506842939,758,820,841051,904595,63544,6
"2512205695_CP002987-gene_1133-gene-1210",2512205695,1133,1210,1271969,1343155,71186,6
"2508526980_Oweho_Contig158_1-gene_3095-gene-3160",2508526980,3095,3160,3568382,3630543,62161,6
"2558913389_P161DRAFT_scf7180000000002_quiver_dupTrim_7254_1-gene_1327-gene-1403",2558913389,1327,1403,1521192,1603538,82346,6
"2558913389_P161DRAFT_scf7180000000002_quiver_dupTrim_7254_1-gene_2929-gene-2945",2558913389,2929,2945,3398063,3408189,10126,6
"2558913389_P161DRAFT_scf7180000000002_quiver_dupTrim_7254_1-gene_719-gene-769",2558913389,719,769,846805,897547,50742,6
"2540348206_FO203363-gene_1760-gene-1807",2540348206,1760,1807,1925568,1973366,47798,6
"2540348206_FO203363-gene_476-gene-491",2540348206,476,491,534629,544335,9706,6
"2667542034_Ga0114080_11-gene_3001-gene-3089",2667542034,3001,3089,2559212,2637072,77860,6
"647533596_NZ_DS995276-gene_101-gene-177",647533596,101,177,89662,148538,58876,6
"2721801272_Ga0176028_11-gene_545-gene-627",2721801272,545,627,622299,702120,79821,6
"2721801272_Ga0176028_11-gene_1468-gene-1515",2721801272,1468,1515,1744424,1799780,55356,6
"2721801272_Ga0176028_11-gene_2388-gene-2442",2721801272,2388,2442,2812818,2863988,51170,6
"2721801272_Ga0176028_11-gene_2659-gene-2729",2721801272,2659,2729,3102370,3165915,63545,6
"2509292657_JoomaDRAFT_JMA_2-gene_188-gene-250",2509292657,188,250,207633,267388,59755,6
"2511244427_NC_016078-gene_2577-gene-2641",2511244427,2577,2641,2647488,2705674,58186,6
"2540348160_CP001397-gene_2236-gene-2319",2540348160,2236,2319,2565003,2657973,92970,6
"2540348160_CP001397-gene_783-gene-806",2540348160,783,806,869910,890666,20756,6
"2540348160_CP001397-gene_2886-gene-3002",2540348160,2886,3002,3307119,3434800,127681,6
"2540348160_CP001397-gene_2556-gene-2669",2540348160,2556,2669,2941719,3067077,125358,6
"2540348160_CP001397-gene_208-gene-273",2540348160,208,273,269200,338223,69023,6
"2540348160_CP001397-gene_592-gene-685",2540348160,592,685,678526,760688,82162,6
"650716068_NC_015458-gene_209-gene-304",650716068,209,304,243624,372854,129230,6
"2503755728_Ddes_Contig54-gene_2498-gene-2537",2503755728,2498,2537,2718908,2774854,55946,6
"641522729_NC_010674-gene_1541-gene-1594",641522729,1541,1594,1662386,1715425,53039,6
"639633066_NC_008571-gene_2377-gene-2446",639633066,2377,2446,2682923,2758772,75849,6
"639633066_NC_008571-gene_797-gene-845",639633066,797,845,947451,993402,45951,6
"2556981731_CP006939-gene_612-gene-659",2556981731,612,659,693062,736116,43054,6
"2556981731_CP006939-gene_2915-gene-3011",2556981731,2915,3011,3313349,3430421,117072,6
"2690318780_Ga0045920_11-gene_1547-gene-1599",2690318780,1547,1599,1663315,1716101,52786,6
"2667536837_Ga0104699_11-gene_7-gene-79",2667536837,7,79,6118,89812,83694,6
"2667536837_Ga0104699_11-gene_1934-gene-1962",2667536837,1934,1962,2084320,2114365,30045,6
"646564593_NC_014008-gene_266-gene-307",646564593,266,307,357993,383617,25624,6
"646564593_NC_014008-gene_1988-gene-2006",646564593,1988,2006,2472434,2528606,56172,6
"646564593_NC_014008-gene_540-gene-562",646564593,540,562,723636,738849,15213,6
"646564593_NC_014008-gene_3018-gene-3039",646564593,3018,3039,3694872,3709458,14586,6
"2540348203_FO203427-gene_1208-gene-1305",2540348203,1208,1305,1332685,1409566,76881,6
"647533454_NZ_DS989898-gene_1565-gene-1654",647533454,1565,1654,1607913,1703106,95193,6
"647533454_NZ_DS989898-gene_3061-gene-3126",647533454,3061,3126,3144119,3191163,47044,6
"2596648949_LY87DRAFT_unitig_0_quiver_1-gene_3027-gene-3090",2596648949,3027,3090,3425272,3497000,71728,6
"2596648949_LY87DRAFT_unitig_0_quiver_1-gene_1984-gene-2095",2596648949,1984,2095,2235835,2351633,115798,6
"2511051433_CP002901-gene_385-gene-538",2511051433,385,538,395264,537992,142728,6
"2511051433_CP002901-gene_2995-gene-3110",2511051433,2995,3110,2887013,2970878,83865,6
"2511051433_CP002901-gene_2025-gene-2117",2511051433,2025,2117,1986387,2061217,74830,6
"2511051433_CP002901-gene_2545-gene-2686",2511051433,2545,2686,2464892,2573542,108650,6
"646311903_NC_013222-gene_2004-gene-2051",646311903,2004,2051,2313157,2350122,36965,6
"646311903_NC_013222-gene_201-gene-233",646311903,201,233,250985,281140,30155,6
"2724812732_K10K4_chromosome1-gene_1339-gene-1363",2724812732,1339,1363,1481535,1498667,17132,6
"2724812732_K10K4_chromosome1-gene_1758-gene-1857",2724812732,1758,1857,1951163,2063015,111852,6
"637000420_NC_007484-gene_386-gene-472",637000420,386,472,423923,489818,65895,6
"2724812413_K04M3_chromosome1-gene_1373-gene-1397",2724812413,1373,1397,1508151,1525283,17132,6
"2724812413_K04M3_chromosome1-gene_1784-gene-1883",2724812413,1784,1883,1970202,2082054,111852,6
"2724812419_K05K4_chromosome1-gene_1361-gene-1385",2724812419,1361,1385,1497978,1515110,17132,6
"2724812419_K05K4_chromosome1-gene_1785-gene-1884",2724812419,1785,1884,1967607,2079458,111851,6
"2724812408_K04M1_chromosome1-gene_1370-gene-1394",2724812408,1370,1394,1503811,1520943,17132,6
"2724812408_K04M1_chromosome1-gene_1777-gene-1877",2724812408,1777,1877,1965862,2077714,111852,6
"2724812723_K06K5_chromosome1-gene_1371-gene-1395",2724812723,1371,1395,1503287,1520419,17132,6
"2724812723_K06K5_chromosome1-gene_1777-gene-1876",2724812723,1777,1876,1965338,2077190,111852,6
"2724812416_K04M5_chromosome1-gene_1765-gene-1865",2724812416,1765,1865,1963657,2075509,111852,6
"2724812416_K04M5_chromosome1-gene_1337-gene-1361",2724812416,1337,1361,1481536,1498668,17132,6
"2724812406_K01M1_chromosome1-gene_1769-gene-1868",2724812406,1769,1868,1962332,2074184,111852,6
"2724812406_K01M1_chromosome1-gene_1363-gene-1387",2724812406,1363,1387,1500281,1517413,17132,6
"2724812734_K08M3_chromosome1-gene_1360-gene-1384",2724812734,1360,1384,1498822,1515954,17132,6
"2724812734_K08M3_chromosome1-gene_1770-gene-1870",2724812734,1770,1870,1960873,2072725,111852,6
"2724812731_K09K1_contig000002-gene_192-gene-216",2724812731,192,216,214660,231792,17132,6
"2724812731_K09K1_contig000002-gene_2779-gene-2877",2724812731,2779,2877,3110919,3219335,108416,6
"2718228555_Ga0175862_11-gene_817-gene-837",2718228555,817,837,810165,828036,17871,6
"650716118_NC_015638-gene_2872-gene-2918",650716118,2872,2918,3187557,3228555,40998,6
"2549075848_RCA23c-gene_1269-gene-1366",2549075848,1269,1366,1323803,1426939,103136,6
"2504643033_SYNPCC8807DRAFT_8807_chromosome-gene_80-gene-98",2504643033,80,98,94011,104165,10154,6
"2504643047_SYNPCC73109DRAFT_73109_chromosome-gene_1788-gene-1815",2504643047,1788,1815,2000010,2028458,28448,6
"2504643047_SYNPCC73109DRAFT_73109_chromosome-gene_1921-gene-1942",2504643047,1921,1942,2155308,2167710,12402,6
"646311952_NC_013456-gene_1539-gene-1644",646311952,1539,1644,1746774,1849178,102404,6
"2718228224_Ga0176053_11-gene_1461-gene-1516",2718228224,1461,1516,1451904,1497385,45481,6
"2718228346_Ga0175161_11-gene_1608-gene-1701",2718228346,1608,1701,1845504,1923206,77702,6
"2721801511_Ga0175657_12-gene_2685-gene-2714",2721801511,2685,2714,2702606,2726565,23959,6
"2663809665_Ga0114161_11-gene_1830-gene-1843",2663809665,1830,1843,2068306,2079871,11565,6
"2663809665_Ga0114161_11-gene_533-gene-627",2663809665,533,627,606913,709125,102212,6
"2526170607_CA2559_HTCC2559_1-gene_53-gene-93",2526170607,53,93,85933,123820,37887,6
"648028061_NC_014414-gene_2294-gene-2320",648028061,2294,2320,2476066,2504856,28790,6
"648028061_NC_014414-gene_1047-gene-1130",648028061,1047,1130,1104336,1199278,94942,6
"2622780069_CP011373-gene_873-gene-915",2622780069,873,915,939171,981858,42687,6
"2622780069_CP011373-gene_56-gene-93",2622780069,56,93,47110,78742,31632,6
"647535429_NZ_GG704599-gene_222-gene-240",647535429,222,240,222002,243554,21552,6
"647533516_NZ_DS990556-gene_2410-gene-2507",647533516,2410,2507,2403035,2503079,100044,6
"2507267694_KS100_Contig_1-gene_1550-gene-1564",2507267694,1550,1564,1551271,1560320,9049,6
"2507267694_KS100_Contig_1-gene_1083-gene-1181",2507267694,1083,1181,1070014,1156405,86391,6
"2507267694_KS100_Contig_1-gene_1733-gene-1831",2507267694,1733,1831,1708012,1777854,69842,6
"2507267694_KS100_Contig_1-gene_2360-gene-2459",2507267694,2360,2459,2275983,2360575,84592,6
"2507267694_KS100_Contig_1-gene_1651-gene-1717",2507267694,1651,1717,1642710,1698526,55816,6
"2507267694_KS100_Contig_1-gene_627-gene-665",2507267694,627,665,653723,686458,32735,6
"646564595_NC_014010-gene_1727-gene-1753",646564595,1727,1753,1853620,1880413,26793,6
"2513265731_NZ_AGIF02000001-gene_1886-gene-1902",2513265731,1886,1902,2087139,2097722,10583,6
"2507281848_Syn8016_Contig50_1-gene_297-gene-400",2507281848,297,400,248809,335127,86318,6
"2507281848_Syn8016_Contig50_1-gene_1207-gene-1278",2507281848,1207,1278,1136273,1192649,56376,6
"2507281848_Syn8016_Contig50_1-gene_33-gene-80",2507281848,33,80,30082,61332,31250,6
"2507281848_Syn8016_Contig50_1-gene_494-gene-593",2507281848,494,593,422160,523844,101684,6
"2507281848_Syn8016_Contig50_1-gene_2667-gene-2690",2507281848,2667,2690,2586837,2600341,13504,6
"2507281848_Syn8016_Contig50_1-gene_125-gene-224",2507281848,125,224,108021,183191,75170,6
"2507281848_Syn8016_Contig50_1-gene_2305-gene-2399",2507281848,2305,2399,2239804,2334181,94377,6
"640069312_NC_008820-gene_1641-gene-1710",640069312,1641,1710,1786097,1864949,78852,6
"640069312_NC_008820-gene_244-gene-322",640069312,244,322,284900,378422,93522,6
"640069312_NC_008820-gene_936-gene-1035",640069312,936,1035,1013875,1109970,96095,6
"640069312_NC_008820-gene_847-gene-912",640069312,847,912,918930,986846,67916,6
"2509602057_Halha_Contig26_1-gene_1232-gene-1253",2509602057,1232,1253,1274933,1288280,13347,6
"2509602057_Halha_Contig26_1-gene_1873-gene-1921",2509602057,1873,1921,1953601,1984022,30421,6
"650716048_NC_015391-gene_65-gene-163",650716048,65,163,71999,152397,80398,6
"650716048_NC_015391-gene_866-gene-897",650716048,866,897,914974,934565,19591,6
"637000608_NC_008319-gene_2126-gene-2162",637000608,2126,2162,2112266,2144903,32637,6
"637000608_NC_008319-gene_1551-gene-1652",637000608,1551,1652,1573811,1656493,82682,6
"637000608_NC_008319-gene_957-gene-1015",637000608,957,1015,966208,1024539,58331,6
"637000608_NC_008319-gene_2428-gene-2526",637000608,2428,2526,2417975,2517479,99504,6
"637000608_NC_008319-gene_558-gene-657",637000608,558,657,578864,668318,89454,6
"637000608_NC_008319-gene_716-gene-809",637000608,716,809,729363,808899,79536,6
"2517287732_B044DRAFT_scaffold1_1-gene_77-gene-121",2517287732,77,121,78702,110555,31853,6
"2507267692_KS49_KORDI_49_1-gene_1041-gene-1136",2507267692,1041,1136,1092817,1166620,73803,6
"2507267692_KS49_KORDI_49_1-gene_789-gene-843",2507267692,789,843,822472,858847,36375,6
"2507267692_KS49_KORDI_49_1-gene_1148-gene-1217",2507267692,1148,1217,1174997,1221733,46736,6
"2507267692_KS49_KORDI_49_1-gene_1739-gene-1755",2507267692,1739,1755,1736079,1747397,11318,6
"2507267692_KS49_KORDI_49_1-gene_2109-gene-2199",2507267692,2109,2199,2113072,2197794,84722,6
"2576887216_P163DRAFT_scf7180000000039_quiver_5-gene_969-gene-1028",2576887216,969,1028,1095440,1152405,56965,6
"2576887216_P163DRAFT_scf7180000000039_quiver_5-gene_2212-gene-2298",2576887216,2212,2298,2444487,2546222,101735,6
"2507267693_KS52_KORDI_52_1-gene_513-gene-541",2507267693,513,541,506126,526034,19908,6
"2507267693_KS52_KORDI_52_1-gene_1479-gene-1578",2507267693,1479,1578,1402028,1465532,63504,6
"2507267693_KS52_KORDI_52_1-gene_2069-gene-2111",2507267693,2069,2111,1935128,1973421,38293,6
"2507267693_KS52_KORDI_52_1-gene_1703-gene-1747",2507267693,1703,1747,1578653,1613693,35040,6
"2507267693_KS52_KORDI_52_1-gene_986-gene-1073",2507267693,986,1073,944688,1025271,80583,6
"2507267693_KS52_KORDI_52_1-gene_1245-gene-1272",2507267693,1245,1272,1188696,1209309,20613,6
"2507267693_KS52_KORDI_52_1-gene_1871-gene-1934",2507267693,1871,1934,1737091,1793207,56116,6
"2507267693_KS52_KORDI_52_1-gene_763-gene-810",2507267693,763,810,720704,778258,57554,6
"640753031_NC_009663-gene_717-gene-808",640753031,717,808,721446,799971,78525,6
"640753031_NC_009663-gene_2078-gene-2108",640753031,2078,2108,2086610,2113648,27038,6
"2509292655_ThesiDRAFT_TSF_1-gene_932-gene-1033",2509292655,932,1033,878124,968801,90677,6
"2718228072_Ga0174827_11-gene_1264-gene-1293",2718228072,1264,1293,1337568,1351588,14020,6
"637000441_NC_007516-gene_2596-gene-2707",637000441,2596,2707,2284116,2395236,111120,6
"637000441_NC_007516-gene_969-gene-1002",637000441,969,1002,896600,920504,23904,6
"637000441_NC_007516-gene_1546-gene-1648",637000441,1546,1648,1389679,1452292,62613,6
"637000441_NC_007516-gene_1283-gene-1297",637000441,1283,1297,1152783,1159946,7163,6
"637000441_NC_007516-gene_1872-gene-1892",637000441,1872,1892,1623201,1638284,15083,6
"637000441_NC_007516-gene_1720-gene-1755",637000441,1720,1755,1522910,1544433,21523,6
"637000441_NC_007516-gene_1086-gene-1155",637000441,1086,1155,992705,1036199,43494,6
"637000441_NC_007516-gene_1976-gene-2039",637000441,1976,2039,1708133,1756052,47919,6
"638366418_NZ_AANA01000001-gene_1438-gene-1454",638366418,1438,1454,1643207,1659911,16704,6
