"Fragment","Scaffold.ID","Gene.Start","Gene.End","bp.Start","bp.End","Fragment.Length"
"647533937_NZ_DS999412-circular-gene_1745-gene_1810",647533937,1745,1810,1905440,1969070,63630
"643348578_NC_011566-gene_2273-gene_2282",643348578,2273,2282,2690277,2700247,9970
"2526166977_SER39009_Serratia_39006_draft_12-05-13_1-gene_2589-gene_2649",2526166977,2589,2649,2875756,2917328,41572
"2518681435_CP003677-gene_1360-gene_1414",2518681435,1360,1414,1476813,1518304,41491
"641522729_NC_010674-gene_2172-gene_2223",641522729,2172,2223,2330638,2362484,31846
"641522729_NC_010674-gene_2639-gene_2721",641522729,2639,2721,2821307,2873956,52649
"2690318780_Ga0045920_11-gene_2185-gene_2236",2690318780,2185,2236,2331572,2363418,31846
"2724812731_K09K1_contig000002-gene_3087-gene_3096",2724812731,3087,3096,3459391,3465668,6277
"647010922_NZ_ACZV01000004-circular-gene_818-gene_861",647010922,818,861,929076,962050,32974
"2517093774_Syn9616DRAFT_scaffold1_1-circular-gene_431-gene_530",2517093774,431,530,385623,463513,77890
"650377989_CP002377-circular-gene_2404-gene_2451",650377989,2404,2451,2595958,2633110,37152
"643692038_NC_012440-circular-gene_1738-gene_1798",643692038,1738,1798,1717883,1754803,36920
"641381032_NZ_ABGR01000017-circular-gene_2-gene_32",641381032,2,32,744,35872,35128
"2540355318_H276DRAFT_scaffold00001_1-circular-gene_733-gene_751",2540355318,733,751,758339,773444,15105
"2524708640_K337DRAFT_scaffold00002_2-circular-gene_199-gene_262",2524708640,199,262,216587,263421,46834
"2524708640_K337DRAFT_scaffold00002_2-circular-gene_776-gene_848",2524708640,776,848,811492,867042,55550
"2516493516_NitteDRAFT_scaffold1_1-circular-gene_1828-gene_1876",2516493516,1828,1876,1757417,1802060,44643
"647533937_NZ_DS999412-circular-gene_2641-gene_2698",647533937,2641,2698,2882543,2942386,59843
"647533937_NZ_DS999412-circular-gene_3956-gene_3984",647533937,3956,3984,4300099,4322413,22314
"647533937_NZ_DS999412-circular-gene_187-gene_234",647533937,187,234,168264,205394,37130
"647533937_NZ_DS999412-circular-gene_905-gene_972",647533937,905,972,977246,1027291,50045
"647533937_NZ_DS999412-circular-gene_1913-gene_1937",647533937,1913,1937,2073300,2090605,17305
"647533937_NZ_DS999412-circular-gene_0-gene_50",647533937,0,50,5013276,30348,-4982928
"647533937_NZ_DS999412-circular-gene_4032-gene_4081",647533937,4032,4081,4379596,4410368,30772
"2630977684_Ga0081187_11-circular-gene_3910-gene_4007",2630977684,3910,4007,5386966,5505410,118444
"646311943_NC_013440-gene_1014-gene_1103",646311943,1014,1103,1278302,1380293,101991
"646311943_NC_013440-gene_593-gene_803",646311943,593,803,781640,1031155,249515
"650716148_NC_015711-gene_3723-gene_3820",650716148,3723,3820,4307581,4397533,89952
"650716148_NC_015711-gene_5117-gene_5198",650716148,5117,5198,5952754,6025098,72344
"650716148_NC_015711-gene_7448-gene_7507",650716148,7448,7507,8940043,9002863,62820
"2631041750_Ga0081465_101-gene_1388-gene_1486",2631041750,1388,1486,1781102,1884722,103620
"637000467_NC_007645-gene_2579-gene_2678",637000467,2579,2678,2918487,2994677,76190
"637000467_NC_007645-gene_6132-gene_6174",637000467,6132,6174,6863337,6900524,37187
"637000467_NC_007645-gene_4099-gene_4144",637000467,4099,4144,4654311,4691573,37262
"637000467_NC_007645-gene_5070-gene_5165",637000467,5070,5165,5730149,5820562,90413
"637000467_NC_007645-gene_329-gene_378",637000467,329,378,380499,423375,42876
"643692052_NC_012490-gene_2276-gene_2334",643692052,2276,2334,2444253,2488197,43944
"643692052_NC_012490-gene_2510-gene_2597",643692052,2510,2597,2668810,2727185,58375
"2718228132_Ga0175156_11-gene_1886-gene_2025",2718228132,1886,2025,2063123,2193556,130433
"2506485008_Contig317-gene_4573-gene_4589",2506485008,4573,4589,5300854,5314526,13672
"2506485008_Contig317-gene_861-gene_960",2506485008,861,960,1008892,1090999,82107
"641228507_NC_009997-gene_771-gene_828",641228507,771,828,902045,946782,44737
"641228507_NC_009997-gene_2253-gene_2350",641228507,2253,2350,2634975,2726256,91281
"641228507_NC_009997-gene_2938-gene_2986",641228507,2938,2986,3439806,3477767,37961
"641228507_NC_009997-gene_2143-gene_2194",641228507,2143,2194,2526485,2571522,45037
"641228507_NC_009997-gene_2263-gene_2355",641228507,2263,2355,2649580,2731034,81454
"2631013058_Ga0046381_11-gene_770-gene_828",2631013058,770,828,900951,945080,44129
"2631013058_Ga0046381_11-gene_2879-gene_2918",2631013058,2879,2918,3389466,3420793,31327
"2631013058_Ga0046381_11-gene_2102-gene_2153",2631013058,2102,2153,2485996,2531033,45037
"651053104_CP002811-gene_1372-gene_1427",651053104,1372,1427,1549973,1586911,36938
"651053104_CP002811-gene_3763-gene_3823",651053104,3763,3823,4303951,4352302,48351
"651053104_CP002811-gene_2311-gene_2346",651053104,2311,2346,2618435,2646472,28037
"640753033_NC_009665-gene_2114-gene_2167",640753033,2114,2167,2481131,2527824,46693
"640753033_NC_009665-gene_734-gene_792",640753033,734,792,865059,908266,43207
"641522617_NC_010334-gene_1305-gene_1365",641522617,1305,1365,1570540,1619476,48936
"2524037964_FO203503-gene_4414-gene_4444",2524037964,4414,4444,5035903,5064438,28535
"637000580_NC_008228-gene_681-gene_739",637000580,681,739,774567,826700,52133
"2728434717_Ga0175483_11-gene_4890-gene_4960",2728434717,4890,4960,4971246,5032005,60759
"2728434717_Ga0175483_11-gene_2299-gene_2331",2728434717,2299,2331,2295307,2324472,29165
"2728434717_Ga0175483_11-gene_3929-gene_4004",2728434717,3929,4004,3999581,4061820,62239
"643348595_NC_011663-gene_757-gene_814",643348595,757,814,882667,925947,43280
"643348595_NC_011663-gene_2594-gene_2664",643348595,2594,2664,3062136,3116455,54319
"2507281626_Sbal625_Contig118_1-gene_2046-gene_2094",2507281626,2046,2094,2452419,2497104,44685
"2507281626_Sbal625_Contig118_1-gene_2172-gene_2219",2507281626,2172,2219,2588967,2627708,38741
"640069332_NC_009052-gene_1283-gene_1342",640069332,1283,1342,1444815,1486320,41505
"640069332_NC_009052-gene_3681-gene_3735",640069332,3681,3735,4211115,4254676,43561
"640069332_NC_009052-gene_2229-gene_2260",640069332,2229,2260,2519643,2548612,28969
"2513256208_cola_cola-finished-ohne-overlap_screen_ace_1_1-gene_1652-gene_1755",2513256208,1652,1755,1921658,2020467,98809
"2718228709_Ga0175363_11-gene_1768-gene_1809",2718228709,1768,1809,2261011,2290543,29532
"2718228709_Ga0175363_11-gene_986-gene_1083",2718228709,986,1083,1319453,1390860,71407
"2561539978_Calab_Cab_131026_1-gene_1768-gene_1809",2561539978,1768,1809,2261011,2290543,29532
"2561539978_Calab_Cab_131026_1-gene_986-gene_1083",2561539978,986,1083,1319453,1390860,71407
"2643222989_Cab_131026-gene_191-gene_232",2643222989,191,232,237356,266888,29532
"2643222989_Cab_131026-gene_3237-gene_3334",2643222989,3237,3334,4274339,4345746,71407
"646564597_NC_014012-gene_2007-gene_2037",646564597,2007,2037,2505011,2528729,23718
"2526166977_SER39009_Serratia_39006_draft_12-05-13_1-gene_4119-gene_4180",2526166977,4119,4180,4658820,4703210,44390
"2526166977_SER39009_Serratia_39006_draft_12-05-13_1-gene_2475-gene_2515",2526166977,2475,2515,2763218,2797702,34484
"2524031326_Shewanella-gene_1665-gene_1720",2524031326,1665,1720,1952220,1998477,46257
"2619690354_Ga0074067_11-gene_1683-gene_1739",2619690354,1683,1739,1867246,1907731,40485
"2619690354_Ga0074067_11-gene_3019-gene_3085",2619690354,3019,3085,3258811,3308244,49433
"2619690354_Ga0074067_11-gene_3758-gene_3822",2619690354,3758,3822,4032892,4086706,53814
"637000611_NC_008322-gene_717-gene_769",637000611,717,769,819483,855165,35682
"644736375_NC_012850-gene_823-gene_861",644736375,823,861,836942,861202,24260
"639633068_NC_008576-gene_2853-gene_3064",639633068,2853,3064,3450321,3618086,167765
"639633068_NC_008576-gene_2665-gene_2747",639633068,2665,2747,3230037,3315977,85940
"639633068_NC_008576-gene_1792-gene_1805",639633068,1792,1805,2118243,2128708,10465
"639633068_NC_008576-gene_1761-gene_1772",639633068,1761,1772,2086351,2095198,8847
"639633068_NC_008576-gene_2092-gene_2188",639633068,2092,2188,2482937,2569493,86556
"639633068_NC_008576-gene_1292-gene_1425",639633068,1292,1425,1527944,1634506,106562
"650716032_NC_015275-gene_951-gene_1022",650716032,951,1022,1097422,1137768,40346
"650716032_NC_015275-gene_2749-gene_2844",650716032,2749,2844,2984437,3049840,65403
"650716032_NC_015275-gene_735-gene_900",650716032,735,900,914850,1048086,133236
"650716032_NC_015275-gene_1198-gene_1217",650716032,1198,1217,1347441,1365519,18078
"650716032_NC_015275-gene_1849-gene_1912",650716032,1849,1912,2051269,2090332,39063
"639633107_NC_008750-gene_2904-gene_2975",639633107,2904,2975,3308788,3365148,56360
"639633107_NC_008750-gene_2480-gene_2560",639633107,2480,2560,2832008,2887378,55370
"2506213072_Contig398-gene_1804-gene_1865",2506213072,1804,1865,2005664,2053485,47821
"2506213072_Contig398-gene_4176-gene_4195",2506213072,4176,4195,4652481,4664967,12486
"2524031327_Shewanella-gene_3320-gene_3369",2524031327,3320,3369,3865190,3906314,41124
"2517487235_scaffold00006-gene_2294-gene_2391",2517487235,2294,2391,2349298,2426553,77255
"2521194441_CP003845-gene_2449-gene_2500",2521194441,2449,2500,2891581,2933581,42000
"650377919_CP001978-gene_1950-gene_2018",650377919,1950,2018,2063045,2110993,47948
"650377919_CP001978-gene_644-gene_703",650377919,644,703,671039,712504,41465
"642555224_NC_011138-gene_754-gene_825",642555224,754,825,834034,889750,55716
"2597512639_Ga0036914_gi564132530_1-gene_2218-gene_2230",2597512639,2218,2230,2399994,2408175,8181
"2597512639_Ga0036914_gi564132530_1-gene_1146-gene_1179",2597512639,1146,1179,1238745,1276442,37697
"2721800935_Ga0175699_12-gene_2062-gene_2159",2721800935,2062,2159,2138964,2233801,94837
"2721800935_Ga0175699_12-gene_1067-gene_1088",2721800935,1067,1088,1126960,1143473,16513
"2521191523_Phaar_neu_scaffold_2516677464_1-gene_2113-gene_2204",2521191523,2113,2204,2203286,2280615,77329
"2521191523_Phaar_neu_scaffold_2516677464_1-gene_2017-gene_2055",2521191523,2017,2055,2116226,2145392,29166
"2521191523_Phaar_neu_scaffold_2516677464_1-gene_1-gene_82",2521191523,1,82,0,63298,63298
"2521191523_Phaar_neu_scaffold_2516677464_1-gene_1517-gene_1561",2521191523,1517,1561,1606892,1639329,32437
"2512569605_Leime_Contig76_3-gene_3039-gene_3094",2512569605,3039,3094,3066207,3120558,54351
"2512569605_Leime_Contig76_3-gene_1289-gene_1357",2512569605,1289,1357,1295144,1343567,48423
"2512569605_Leime_Contig76_3-gene_1786-gene_1861",2512569605,1786,1861,1791364,1854045,62681
"2512569605_Leime_Contig76_3-gene_2139-gene_2184",2512569605,2139,2184,2141757,2177757,36000
"2687454401_Ga0133388_11-gene_2032-gene_2128",2687454401,2032,2128,2114360,2195720,81360
"2687454401_Ga0133388_11-gene_2609-gene_2695",2687454401,2609,2695,2734000,2804434,70434
"2687454401_Ga0133388_11-gene_3574-gene_3699",2687454401,3574,3699,3767093,3867276,100183
"2667542047_Ga0105927_11-gene_3574-gene_3693",2667542047,3574,3693,3771957,3868806,96849
"2667542047_Ga0105927_11-gene_2041-gene_2135",2667542047,2041,2135,2118291,2199626,81335
"2667542047_Ga0105927_11-gene_2614-gene_2700",2667542047,2614,2700,2737904,2808661,70757
"2622780072_scf7180000000004-gene_1974-gene_2063",2622780072,1974,2063,2351852,2430539,78687
"637000159_NC_003911-gene_1040-gene_1075",637000159,1040,1075,1080764,1105118,24354
"2558913391_P176DRAFT_scf7180000000002_quiver_dupTrim_6579_1-gene_2375-gene_2437",2558913391,2375,2437,2766915,2814914,47999
"637000312_NC_006370-gene_1312-gene_1372",637000312,1312,1372,1478766,1530840,52074
"646564576_NC_013960-gene_932-gene_1037",646564576,932,1037,954143,1034729,80586
"2512205695_CP002987-gene_3566-gene_3646",2512205695,3566,3646,3955988,4009903,53915
"2512205695_CP002987-gene_3164-gene_3224",2512205695,3164,3224,3568170,3601737,33567
"2667542034_Ga0114080_11-gene_2641-gene_2706",2667542034,2641,2706,2266564,2311513,44949
"2511244427_NC_016078-gene_672-gene_732",2511244427,672,732,676603,719639,43036
"2511244427_NC_016078-gene_909-gene_925",2511244427,909,925,916135,932318,16183
"2667541935_Ga0102658_12-gene_1305-gene_1353",2667541935,1305,1353,1485562,1523601,38039
"2597520218_Ga0032872_gi461490773_1-gene_433-gene_485",2597520218,433,485,506714,542314,35600
"647533601_NZ_DS995281-gene_3189-gene_3242",647533601,3189,3242,3275278,3337031,61753
"2645768409_Ga0069294_12-gene_1623-gene_1688",2645768409,1623,1688,1857872,1898581,40709
"650716102_NC_015590-gene_229-gene_295",650716102,229,295,264429,314278,49849
"650716102_NC_015590-gene_1342-gene_1435",650716102,1342,1435,1377451,1449441,71990
"650716102_NC_015590-gene_1805-gene_1848",650716102,1805,1848,1841924,1873068,31144
"650716102_NC_015590-gene_750-gene_840",650716102,750,840,790860,851832,60972
"650716102_NC_015590-gene_2233-gene_2317",650716102,2233,2317,2288740,2355208,66468
"641522729_NC_010674-gene_862-gene_917",641522729,862,917,935466,973377,37911
"641522729_NC_010674-gene_1816-gene_1896",641522729,1816,1896,1979655,2030044,50389
"641522729_NC_010674-gene_2305-gene_2328",641522729,2305,2328,2463246,2483517,20271
"639633066_NC_008571-gene_2228-gene_2314",639633066,2228,2314,2547178,2605024,57846
"647533810_NZ_DS999213-gene_3456-gene_3479",647533810,3456,3479,3580544,3600594,20050
"2690318780_Ga0045920_11-gene_868-gene_923",2690318780,868,923,936395,974306,37911
"2690318780_Ga0045920_11-gene_1827-gene_1921",2690318780,1827,1921,1980589,2046533,65944
"2690318780_Ga0045920_11-gene_2646-gene_2739",2690318780,2646,2739,2813381,2874917,61536
"2690318780_Ga0045920_11-gene_2318-gene_2341",2690318780,2318,2341,2464182,2484453,20271
"640753071_NC_009783-gene_1750-gene_1832",640753071,1750,1832,1945668,2014249,68581
"640753071_NC_009783-gene_2103-gene_2124",640753071,2103,2124,2305531,2320928,15397
"2561541728_CP006605-gene_366-gene_387",2561541728,366,387,410068,425465,15397
"2561541728_CP006605-gene_664-gene_745",2561541728,664,745,715573,784101,68528
"637000620_NC_008358-gene_2448-gene_2531",637000620,2448,2531,2600270,2709098,108828
"2648578723_Ga0045936_12-gene_1323-gene_1352",2648578723,1323,1352,1515663,1536111,20448
"2648578723_Ga0045936_12-gene_2016-gene_2109",2648578723,2016,2109,2296214,2377697,81483
"2540348203_FO203427-gene_2262-gene_2352",2540348203,2262,2352,2477813,2569803,91990
"647533454_NZ_DS989898-gene_1834-gene_1925",647533454,1834,1925,1883599,1963726,80127
"637000323_NC_006510-gene_498-gene_574",637000323,498,574,538104,581745,43641
"646311903_NC_013222-gene_2691-gene_2741",646311903,2691,2741,3087155,3128656,41501
"637000284_NC_006138-gene_1537-gene_1593",637000284,1537,1593,1735086,1787735,52649
"637000284_NC_006138-gene_1986-gene_2086",637000284,1986,2086,2255392,2373762,118370
"2512211939_PhacaeDRAFT_Scaffold1_6-gene_3366-gene_3405",2512211939,3366,3405,3496131,3520745,24614
"2512211939_PhacaeDRAFT_Scaffold1_6-gene_1-gene_35",2512211939,1,35,0,21245,21245
"2512211939_PhacaeDRAFT_Scaffold1_6-gene_2735-gene_2790",2512211939,2735,2790,2857205,2898302,41097
"2724812732_K10K4_chromosome1-gene_1532-gene_1548",2724812732,1532,1548,1701740,1711489,9749
"2724812732_K10K4_chromosome1-gene_1209-gene_1253",2724812732,1209,1253,1355664,1393405,37741
"2724812413_K04M3_chromosome1-gene_1209-gene_1253",2724812413,1209,1253,1355665,1393406,37741
"2724812419_K05K4_chromosome1-gene_1557-gene_1573",2724812419,1557,1573,1718183,1727552,9369
"2724812419_K05K4_chromosome1-gene_1231-gene_1275",2724812419,1231,1275,1372107,1409848,37741
"2724812408_K04M1_chromosome1-gene_1240-gene_1284",2724812408,1240,1284,1377940,1415681,37741
"2724812723_K06K5_chromosome1-gene_1241-gene_1285",2724812723,1241,1285,1377416,1415157,37741
"2724812416_K04M5_chromosome1-gene_1207-gene_1251",2724812416,1207,1251,1355665,1393406,37741
"2724812406_K01M1_chromosome1-gene_1233-gene_1277",2724812406,1233,1277,1374410,1412151,37741
"2724812734_K08M3_chromosome1-gene_1230-gene_1274",2724812734,1230,1274,1372951,1410692,37741
"2724812731_K09K1_contig000002-gene_302-gene_346",2724812731,302,346,319923,357665,37742
"2724812731_K09K1_contig000002-gene_1-gene_22",2724812731,1,22,415,11584,11169
"2718228555_Ga0175862_11-gene_3168-gene_3266",2718228555,3168,3266,3222652,3327670,105018
"2718228555_Ga0175862_11-gene_3274-gene_3361",2718228555,3274,3361,3337144,3428222,91078
"2718228555_Ga0175862_11-gene_1409-gene_1459",2718228555,1409,1459,1405091,1454648,49557
"2718227896_Ga0175494_11-gene_2146-gene_2191",2718227896,2146,2191,2589586,2628299,38713
"2627905620_Ga0077997_11-gene_2472-gene_2532",2627905620,2472,2532,2479605,2523479,43874
"642555204_NC_011026-gene_256-gene_282",642555204,256,282,303948,325903,21955
"2549075848_RCA23c-gene_2282-gene_2353",2549075848,2282,2353,2370338,2440463,70125
"646311952_NC_013456-gene_1805-gene_1819",646311952,1805,1819,2033154,2046026,12872
"637000417_NC_007481-gene_1433-gene_1478",637000417,1433,1478,1587400,1623178,35778
"643348691_NC_011963-gene_2988-gene_3036",643348691,2988,3036,3078658,3117660,39002
"643348691_NC_011963-gene_323-gene_394",643348691,323,394,325768,378487,52719
"2718228560_Ga0175864_11-gene_679-gene_734",2718228560,679,734,786863,827832,40969
"2627853750_Ga0079189_11-gene_2309-gene_2332",2627853750,2309,2332,2407663,2423005,15342
"2627853750_Ga0079189_11-gene_1059-gene_1101",2627853750,1059,1101,1103948,1128199,24251
"2627853750_Ga0079189_11-gene_2109-gene_2159",2627853750,2109,2159,2205281,2241253,35972
"2627853750_Ga0079189_11-gene_2747-gene_2783",2627853750,2747,2783,2877000,2902278,25278
"2627853750_Ga0079189_11-gene_728-gene_784",2627853750,728,784,764742,804560,39818
"2627853750_Ga0079189_11-gene_2403-gene_2446",2627853750,2403,2446,2506820,2537239,30419
"2627853750_Ga0079189_11-gene_1309-gene_1413",2627853750,1309,1413,1352277,1437697,85420
"2627853750_Ga0079189_11-gene_829-gene_894",2627853750,829,894,857046,917003,59957
"647535429_NZ_GG704599-gene_2480-gene_2540",647535429,2480,2540,2530324,2587246,56922
"649633102_NC_014831-gene_17-gene_67",649633102,17,67,19306,59135,39829
"647533516_NZ_DS990556-gene_1296-gene_1378",647533516,1296,1378,1284195,1355092,70897
"647533516_NZ_DS990556-gene_624-gene_664",647533516,624,664,616306,656141,39835
"2507267694_KS100_Contig_1-gene_2693-gene_2762",2507267694,2693,2762,2613864,2685797,71933
"2507267694_KS100_Contig_1-gene_203-gene_232",2507267694,203,232,226877,254576,27699
"2507267694_KS100_Contig_1-gene_2020-gene_2084",2507267694,2020,2084,1950549,2008165,57616
"646564595_NC_014010-gene_2295-gene_2316",646564595,2295,2316,2466286,2484416,18130
"646564595_NC_014010-gene_370-gene_416",646564595,370,416,384275,428636,44361
"2718229246_Ga0175211_11-gene_2496-gene_2531",2718229246,2496,2531,2527993,2547486,19493
"2718229246_Ga0175211_11-gene_1632-gene_1696",2718229246,1632,1696,1677150,1717632,40482
"2571071633_BS76DRAFT_scf7180000000002_quiver_dupTrim_10022_1-gene_509-gene_575",2571071633,509,575,529035,577899,48864
"2718228072_Ga0174827_11-gene_1031-gene_1050",2718228072,1031,1050,1110568,1127528,16960
"637000441_NC_007516-gene_539-gene_587",637000441,539,587,516757,552640,35883
"637000441_NC_007516-gene_1761-gene_1851",637000441,1761,1851,1548638,1609705,61067
"2571156966_P166DRAFT_scf7180000000008_quiver_2-gene_408-gene_460",2571156966,408,460,451582,487311,35729
"2675923119_Ga0104434_115-circular-gene_43-gene_152",2675923119,43,152,27608,123395,95787
"2515169221_B108DRAFT_scaffold_25_26-circular-gene_3-gene_14",2515169221,3,14,1960,16733,14773
"2524663017_G410DRAFT_scaffold00003_3-circular-gene_442-gene_469",2524663017,442,469,441096,230,-440866
"2588286426_JAMC01000014-circular-gene_3-gene_18",2588286426,3,18,890,15358,14468
"2627929999_Ga0072914_123-circular-gene_1-gene_17",2627929999,1,17,128,9898,9770
"2517093774_Syn9616DRAFT_scaffold1_1-circular-gene_2737-gene_2781",2517093774,2737,2781,2615499,2645261,29762
"2517093774_Syn9616DRAFT_scaffold1_1-circular-gene_6-gene_37",2517093774,6,37,5336,27908,22572
"2517093774_Syn9616DRAFT_scaffold1_1-circular-gene_1000-gene_1097",2517093774,1000,1097,933842,1006510,72668
"2517093774_Syn9616DRAFT_scaffold1_1-circular-gene_1105-gene_1199",2517093774,1105,1199,1013501,1072615,59114
"2517093774_Syn9616DRAFT_scaffold1_1-circular-gene_831-gene_853",2517093774,831,853,779187,793750,14563
"647533410_NZ_DS989854-circular-gene_108-gene_136",647533410,108,136,167050,197637,30587
"647533410_NZ_DS989854-circular-gene_1-gene_86",647533410,1,86,0,121490,121490
"2585503063_EJ41DRAFT_scaffold00022_22-circular-gene_11-gene_33",2585503063,11,33,6648,27630,20982
"2519109854_F550DRAFT_scaffold00001_1-circular-gene_2034-gene_2059",2519109854,2034,2059,2094654,2116558,21904
"2537605091_AODW01000026-circular-gene_76-gene_93",2537605091,76,93,73462,85457,11995
"2519942254_C505DRAFT_scaffold00018_18-circular-gene_25-gene_80",2519942254,25,80,25826,64448,38622
"2540355318_H276DRAFT_scaffold00001_1-circular-gene_3183-gene_3282",2540355318,3183,3282,3321195,3425231,104036
"2630977689_Ga0081190_11-gene_6748-gene_6761",2630977689,6748,6761,9544825,9557968,13143
"2630977689_Ga0081190_11-gene_4539-gene_4628",2630977689,4539,4628,6482882,6583593,100711
"2630977689_Ga0081190_11-gene_4792-gene_4891",2630977689,4792,4891,6828725,6968914,140189
"2630977689_Ga0081190_11-gene_827-gene_924",2630977689,827,924,1110493,1247883,137390
"2630977689_Ga0081190_11-gene_2458-gene_2533",2630977689,2458,2533,3430431,3541910,111479
"2524708640_K337DRAFT_scaffold00002_2-circular-gene_452-gene_550",2524708640,452,550,462969,552693,89724
"2523241327_G578DRAFT_scaffold00006_6-circular-gene_57-gene_74",2523241327,57,74,48651,61595,12944
"647533937_NZ_DS999412-circular-gene_3605-gene_3702",647533937,3605,3702,3939838,4028861,89023
"2551322073_A132DRAFT_AJYX01000047_1_47-circular-gene_8-gene_29",2551322073,8,29,9838,30399,20561
"2630977684_Ga0081187_11-circular-gene_5613-gene_5707",2630977684,5613,5707,7606015,7719752,113737
"2630977684_Ga0081187_11-circular-gene_1095-gene_1216",2630977684,1095,1216,1487507,1631054,143547
"2630977684_Ga0081187_11-circular-gene_2685-gene_2781",2630977684,2685,2781,3623370,3752077,128707
"2630977684_Ga0081187_11-circular-gene_4673-gene_4725",2630977684,4673,4725,6375942,6425443,49501
"2630977684_Ga0081187_11-circular-gene_2415-gene_2490",2630977684,2415,2490,3240842,3331029,90187
"2630977684_Ga0081187_11-circular-gene_828-gene_924",2630977684,828,924,1106606,1234076,127470
"2630977684_Ga0081187_11-circular-gene_6413-gene_6428",2630977684,6413,6428,8680596,8693336,12740
"2718228070_Ga0174825_11-gene_5539-gene_5638",2718228070,5539,5638,7799776,7939965,140189
"2718228070_Ga0174825_11-gene_5802-gene_5891",2718228070,5802,5891,8185097,8285808,100711
"2718228070_Ga0174825_11-gene_1046-gene_1120",2718228070,1046,1120,1553672,1665151,111479
"2718228070_Ga0174825_11-gene_2654-gene_2751",2718228070,2654,2751,3847699,3985089,137390
"2718228070_Ga0174825_11-gene_3669-gene_3682",2718228070,3669,3682,5210722,5223865,13143
"646311943_NC_013440-gene_873-gene_992",646311943,873,992,1121299,1241803,120504
"646311943_NC_013440-gene_1566-gene_1665",646311943,1566,1665,2096300,2228050,131750
"646311943_NC_013440-gene_6459-gene_6512",646311943,6459,6512,8712981,8786032,73051
"646311943_NC_013440-gene_2885-gene_2983",646311943,2885,2983,3901505,4011359,109854
"646311943_NC_013440-gene_1131-gene_1193",646311943,1131,1193,1429988,1494345,64357
"646311943_NC_013440-gene_1223-gene_1298",646311943,1223,1298,1559422,1674167,114745
"646311943_NC_013440-gene_2613-gene_2694",646311943,2613,2694,3574267,3674500,100233
"646311943_NC_013440-gene_3076-gene_3172",646311943,3076,3172,4195889,4313830,117941
"650716148_NC_015711-gene_1881-gene_2147",650716148,1881,2147,2205341,2511960,306619
"650716148_NC_015711-gene_3139-gene_3236",650716148,3139,3236,3634976,3741271,106295
"650716148_NC_015711-gene_1364-gene_1462",650716148,1364,1462,1605066,1718126,113060
"650716148_NC_015711-gene_878-gene_992",650716148,878,992,1045169,1174972,129803
"2631041829_Ga0081470_101-gene_4803-gene_4899",2631041829,4803,4899,6180476,6301592,121116
"2631041829_Ga0081470_101-gene_874-gene_970",2631041829,874,970,1109040,1224964,115924
"2631041829_Ga0081470_101-gene_3753-gene_3813",2631041829,3753,3813,4856722,4924358,67636
"2631041750_Ga0081465_101-gene_2206-gene_2295",2631041750,2206,2295,2863666,2956141,92475
"2631041750_Ga0081465_101-gene_3177-gene_3262",2631041750,3177,3262,4106562,4227524,120962
"2631041750_Ga0081465_101-gene_1867-gene_1926",2631041750,1867,1926,2396611,2467466,70855
"2631041750_Ga0081465_101-gene_4134-gene_4229",2631041750,4134,4229,5349319,5453043,103724
"637000606_NC_008312-gene_4078-gene_4123",637000606,4078,4123,6533157,6576535,43378
"637000606_NC_008312-gene_1286-gene_1382",637000606,1286,1382,2106565,2242912,136347
"637000606_NC_008312-gene_3386-gene_3484",637000606,3386,3484,5405655,5544111,138456
"637000606_NC_008312-gene_2943-gene_3042",637000606,2943,3042,4713202,4829141,115939
"637000606_NC_008312-gene_1114-gene_1208",637000606,1114,1208,1849434,1966962,117528
"637000606_NC_008312-gene_282-gene_299",637000606,282,299,470714,475205,4491
"637000606_NC_008312-gene_4711-gene_4800",637000606,4711,4800,7446415,7529688,83273
"637000467_NC_007645-gene_3517-gene_3550",637000467,3517,3550,4015384,4055166,39782
"637000467_NC_007645-gene_3387-gene_3472",637000467,3387,3472,3866134,3953635,87501
"637000467_NC_007645-gene_3236-gene_3309",637000467,3236,3309,3698631,3771374,72743
"637000467_NC_007645-gene_6362-gene_6418",637000467,6362,6418,7115730,7187335,71605
"637000467_NC_007645-gene_2880-gene_2978",637000467,2880,2978,3242227,3356516,114289
"637000233_NC_005027-gene_1561-gene_1633",637000233,1561,1633,2156629,2242457,85828
"637000233_NC_005027-gene_4489-gene_4588",637000233,4489,4588,6130429,6236992,106563
"637000233_NC_005027-gene_1-gene_28",637000233,1,28,0,30326,30326
"650716066_NC_015434-gene_2221-gene_2325",650716066,2221,2325,2371225,2477888,106663
"650716066_NC_015434-gene_579-gene_663",650716066,579,663,605894,696261,90367
"650716066_NC_015434-gene_2471-gene_2528",650716066,2471,2528,2660767,2707994,47227
"650716066_NC_015434-gene_5848-gene_5939",650716066,5848,5939,6415347,6529768,114421
"643692052_NC_012490-gene_2927-gene_2959",643692052,2927,2959,3072397,3097283,24886
"643692052_NC_012490-gene_2081-gene_2105",643692052,2081,2105,2239896,2260962,21066
"2508527215_MycrhN_Contig54_1-gene_2757-gene_2855",2508527215,2757,2855,2801592,2893013,91421
"2506535018_Aquba_Contig381-gene_3222-gene_3322",2506535018,3222,3322,3969746,4076128,106382
"2506535018_Aquba_Contig381-gene_4305-gene_4334",2506535018,4305,4334,5294383,5330093,35710
"2506535018_Aquba_Contig381-gene_2596-gene_2688",2506535018,2596,2688,3153720,3263775,110055
"2508501807_SacmaDRAFT_SMG_1-gene_13-gene_105",2508501807,13,105,15093,98516,83423
"2508501807_SacmaDRAFT_SMG_1-gene_5225-gene_5315",2508501807,5225,5315,5423726,5508304,84578
"2508501807_SacmaDRAFT_SMG_1-gene_4114-gene_4201",2508501807,4114,4201,4276285,4357716,81431
"2718228132_Ga0175156_11-gene_4007-gene_4032",2718228132,4007,4032,4352449,4372994,20545
"2506485008_Contig317-gene_2764-gene_2782",2506485008,2764,2782,3233670,3246034,12364
"2506485008_Contig317-gene_4705-gene_4893",2506485008,4705,4893,5443873,5698227,254354
"643692025_NC_012108-gene_1861-gene_1913",643692025,1861,1913,2163671,2214118,50447
"643692025_NC_012108-gene_4277-gene_4332",643692025,4277,4332,4977214,5033916,56702
"2562628756_CP007203-gene_1941-gene_1987",2562628756,1941,1987,2212462,2247794,35332
"643348578_NC_011566-gene_2857-gene_2879",643348578,2857,2879,3378505,3397747,19242
"637000158_NC_003910-gene_774-gene_798",637000158,774,798,887208,903063,15855
"637000158_NC_003910-gene_303-gene_340",637000158,303,340,350248,386593,36345
"651053104_CP002811-gene_183-gene_227",651053104,183,227,212067,254198,42131
"2512564983_OA238_c-gene_4348-gene_4433",2512564983,4348,4433,4048829,4116476,67647
"2524037964_FO203503-gene_3169-gene_3261",2524037964,3169,3261,3567366,3644024,76658
"2728434717_Ga0175483_11-gene_825-gene_914",2728434717,825,914,816091,870732,54641
"2728434717_Ga0175483_11-gene_4310-gene_4351",2728434717,4310,4351,4389037,4425797,36760
"646564612_NC_014041-gene_2018-gene_2041",646564612,2018,2041,2324446,2342794,18348
"646564612_NC_014041-gene_3681-gene_3766",646564612,3681,3766,4256332,4324707,68375
"646564612_NC_014041-gene_3035-gene_3124",646564612,3035,3124,3542923,3622144,79221
"646564612_NC_014041-gene_1172-gene_1265",646564612,1172,1265,1365365,1457088,91723
"646564612_NC_014041-gene_2481-gene_2503",646564612,2481,2503,2867548,2879201,11653
"637000514_NC_007912-gene_1863-gene_1895",637000514,1863,1895,2300286,2326857,26571
"637000514_NC_007912-gene_3099-gene_3115",637000514,3099,3115,3836046,3846111,10065
"637000514_NC_007912-gene_2363-gene_2423",637000514,2363,2423,2926621,2977451,50830
"637000514_NC_007912-gene_434-gene_492",637000514,434,492,518134,568078,49944
"2504762402_Contig38-gene_2938-gene_2958",2504762402,2938,2958,3281385,3294342,12957
"2504762402_Contig38-gene_1644-gene_1740",2504762402,1644,1740,1852324,1946237,93913
"2513256208_cola_cola-finished-ohne-overlap_screen_ace_1_1-gene_3380-gene_3408",2513256208,3380,3408,4004210,4026923,22713
"2513256208_cola_cola-finished-ohne-overlap_screen_ace_1_1-gene_2454-gene_2545",2513256208,2454,2545,2868388,2976331,107943
"2513256208_cola_cola-finished-ohne-overlap_screen_ace_1_1-gene_725-gene_777",2513256208,725,777,894485,949248,54763
"2513256208_cola_cola-finished-ohne-overlap_screen_ace_1_1-gene_1922-gene_1992",2513256208,1922,1992,2230294,2285331,55037
"2513256208_cola_cola-finished-ohne-overlap_screen_ace_1_1-gene_1839-gene_1896",2513256208,1839,1896,2125681,2190492,64811
"2513256208_cola_cola-finished-ohne-overlap_screen_ace_1_1-gene_2288-gene_2356",2513256208,2288,2356,2662208,2736198,73990
"2513256208_cola_cola-finished-ohne-overlap_screen_ace_1_1-gene_1353-gene_1442",2513256208,1353,1442,1596454,1680431,83977
"2513256208_cola_cola-finished-ohne-overlap_screen_ace_1_1-gene_3978-gene_4033",2513256208,3978,4033,4695011,4750386,55375
"2718228709_Ga0175363_11-gene_1456-gene_1505",2718228709,1456,1505,1880414,1934299,53885
"2561539978_Calab_Cab_131026_1-gene_1456-gene_1505",2561539978,1456,1505,1880414,1934299,53885
"2643222989_Cab_131026-gene_3707-gene_3756",2643222989,3707,3756,4835300,4889185,53885
"2504404809_AMB_SN2-gene_1202-gene_1245",2504404809,1202,1245,1419056,1449472,30416
"2504404809_AMB_SN2-gene_3425-gene_3481",2504404809,3425,3481,3959204,4000086,40882
"2504404809_AMB_SN2-gene_2113-gene_2134",2504404809,2113,2134,2440803,2457795,16992
"2521194451_CP003466-gene_2064-gene_2140",2521194451,2064,2140,2267143,2344440,77297
"2554309016_CP006643-gene_4315-gene_4342",2554309016,4315,4342,4319696,4349081,29385
"2526166614_K365DRAFT_scaffold00001_1-gene_2939-gene_3028",2526166614,2939,3028,3144735,3211291,66556
"2526166614_K365DRAFT_scaffold00001_1-gene_2054-gene_2120",2526166614,2054,2120,2182760,2237229,54469
"2526166614_K365DRAFT_scaffold00001_1-gene_70-gene_137",2526166614,70,137,75641,124136,48495
"2526166614_K365DRAFT_scaffold00001_1-gene_1819-gene_1840",2526166614,1819,1840,1908163,1923456,15293
"637000611_NC_008322-gene_1040-gene_1074",637000611,1040,1074,1173198,1208295,35097
"639633068_NC_008576-gene_2295-gene_2394",639633068,2295,2394,2788052,2908490,120438
"650716032_NC_015275-gene_3744-gene_3816",650716032,3744,3816,4059134,4134696,75562
"650716032_NC_015275-gene_1500-gene_1529",650716032,1500,1529,1668325,1688261,19936
"2596658995_LX98DRAFT_unitig_0_quiver_1-gene_1357-gene_1455",2596658995,1357,1455,1600434,1709881,109447
"2596658995_LX98DRAFT_unitig_0_quiver_1-gene_923-gene_1015",2596658995,923,1015,1076589,1190087,113498
"2684693078_Ga0125241_11-gene_2209-gene_2245",2684693078,2209,2245,2643101,2667259,24158
"2718228273_Ga0174870_11-gene_1093-gene_1155",2718228273,1093,1155,1240194,1315681,75487
"2718228273_Ga0174870_11-gene_2263-gene_2345",2718228273,2263,2345,2653856,2732450,78594
"639633099_NC_008711-gene_3189-gene_3244",639633099,3189,3244,3459694,3520334,60640
"639633098_NC_008709-gene_2610-gene_2648",639633098,2610,2648,3123636,3169177,45541
"2524031327_Shewanella-gene_142-gene_160",2524031327,142,160,150457,169260,18803
"2517487235_scaffold00006-gene_2798-gene_2848",2517487235,2798,2848,2825633,2870622,44989
"2517487235_scaffold00006-gene_2686-gene_2731",2517487235,2686,2731,2714027,2761266,47239
"649633075_NC_014759-gene_3428-gene_3459",649633075,3428,3459,4114967,4150955,35988
"649633075_NC_014759-gene_1905-gene_1964",649633075,1905,1964,2330185,2392416,62231
"2521194441_CP003845-gene_2019-gene_2052",2521194441,2019,2052,2399118,2422966,23848
"637000589_NC_008255-gene_2191-gene_2290",637000589,2191,2290,2656102,2751587,95485
"637000589_NC_008255-gene_477-gene_539",637000589,477,539,578980,654530,75550
"637000589_NC_008255-gene_2821-gene_2849",637000589,2821,2849,3365689,3400262,34573
"650377919_CP001978-gene_3109-gene_3128",650377919,3109,3128,3247572,3262409,14837
"650377919_CP001978-gene_69-gene_168",650377919,69,168,77394,163909,86515
"642555224_NC_011138-gene_3586-gene_3618",642555224,3586,3618,4042153,4065027,22874
"2597512639_Ga0036914_gi564132530_1-gene_1826-gene_1849",2597512639,1826,1849,1967982,1989439,21457
"2597512639_Ga0036914_gi564132530_1-gene_3202-gene_3264",2597512639,3202,3264,3458987,3519090,60103
"2597512639_Ga0036914_gi564132530_1-gene_3097-gene_3192",2597512639,3097,3192,3356791,3445787,88996
"2721801484_Ga0175998_12-gene_465-gene_503",2721801484,465,503,549093,572064,22971
"2721801484_Ga0175998_12-gene_2983-gene_3022",2721801484,2983,3022,3567570,3606413,38843
"2512571803_NC_016940-gene_493-gene_534",2512571803,493,534,647889,697810,49921
"2512571803_NC_016940-gene_2600-gene_2706",2512571803,2600,2706,3333163,3468740,135577
"2512571803_NC_016940-gene_3144-gene_3226",2512571803,3144,3226,4010366,4123157,112791
"2512571803_NC_016940-gene_112-gene_205",2512571803,112,205,135529,267910,132381
"2512571803_NC_016940-gene_270-gene_366",2512571803,270,366,350324,502287,151963
"2512571803_NC_016940-gene_3304-gene_3403",2512571803,3304,3403,4233049,4340705,107656
"2512571803_NC_016940-gene_2711-gene_2913",2512571803,2711,2913,3474918,3717888,242970
"2721800935_Ga0175699_12-gene_4069-gene_4106",2721800935,4069,4106,4182293,4208946,26653
"2721800935_Ga0175699_12-gene_1265-gene_1339",2721800935,1265,1339,1329404,1389445,60041
"2721800935_Ga0175699_12-gene_3788-gene_3885",2721800935,3788,3885,3888197,3986037,97840
"2519117607_CP003746-gene_2821-gene_2874",2519117607,2821,2874,3043185,3079999,36814
"2521191523_Phaar_neu_scaffold_2516677464_1-gene_4099-gene_4114",2521191523,4099,4114,4207554,4215395,7841
"2521191523_Phaar_neu_scaffold_2516677464_1-gene_2349-gene_2393",2521191523,2349,2393,2442235,2474606,32371
"2687454401_Ga0133388_11-gene_3422-gene_3469",2687454401,3422,3469,3588492,3653324,64832
"2687454401_Ga0133388_11-gene_397-gene_493",2687454401,397,493,408818,495851,87033
"2667542047_Ga0105927_11-gene_3426-gene_3470",2667542047,3426,3470,3595323,3658705,63382
"2667542047_Ga0105927_11-gene_397-gene_496",2667542047,397,496,408817,498133,89316
"2622780072_scf7180000000004-gene_1460-gene_1474",2622780072,1460,1474,1722181,1727364,5183
"2558913391_P176DRAFT_scf7180000000002_quiver_dupTrim_6579_1-gene_1705-gene_1719",2558913391,1705,1719,1998637,2008375,9738
"2558913391_P176DRAFT_scf7180000000002_quiver_dupTrim_6579_1-gene_3514-gene_3571",2558913391,3514,3571,4077182,4106062,28880
"2558913391_P176DRAFT_scf7180000000002_quiver_dupTrim_6579_1-gene_211-gene_301",2558913391,211,301,236523,342458,105935
"2718228355_Ga0175168_11-gene_1545-gene_1628",2718228355,1545,1628,1786061,1859443,73382
"2506842939_Thimo_Contig50-gene_2222-gene_2287",2506842939,2222,2287,2495885,2560905,65020
"2506842939_Thimo_Contig50-gene_758-gene_820",2506842939,758,820,841051,904595,63544
"2512205695_CP002987-gene_1133-gene_1210",2512205695,1133,1210,1271969,1343155,71186
"2508526980_Oweho_Contig158_1-gene_3095-gene_3160",2508526980,3095,3160,3568382,3630543,62161
"2558913389_P161DRAFT_scf7180000000002_quiver_dupTrim_7254_1-gene_1327-gene_1403",2558913389,1327,1403,1521192,1603538,82346
"2558913389_P161DRAFT_scf7180000000002_quiver_dupTrim_7254_1-gene_2929-gene_2945",2558913389,2929,2945,3398063,3408189,10126
"2558913389_P161DRAFT_scf7180000000002_quiver_dupTrim_7254_1-gene_719-gene_769",2558913389,719,769,846805,897547,50742
"2540348206_FO203363-gene_1760-gene_1807",2540348206,1760,1807,1925568,1973366,47798
"2540348206_FO203363-gene_476-gene_491",2540348206,476,491,534629,544335,9706
"2667542034_Ga0114080_11-gene_3001-gene_3089",2667542034,3001,3089,2559212,2637072,77860
"647533596_NZ_DS995276-gene_101-gene_177",647533596,101,177,89662,148538,58876
"2721801272_Ga0176028_11-gene_545-gene_627",2721801272,545,627,622299,702120,79821
"2721801272_Ga0176028_11-gene_1468-gene_1515",2721801272,1468,1515,1744424,1799780,55356
"2721801272_Ga0176028_11-gene_2388-gene_2442",2721801272,2388,2442,2812818,2863988,51170
"2721801272_Ga0176028_11-gene_2659-gene_2729",2721801272,2659,2729,3102370,3165915,63545
"2509292657_JoomaDRAFT_JMA_2-gene_188-gene_250",2509292657,188,250,207633,267388,59755
"2511244427_NC_016078-gene_2577-gene_2641",2511244427,2577,2641,2647488,2705674,58186
"2540348160_CP001397-gene_2236-gene_2319",2540348160,2236,2319,2565003,2657973,92970
"2540348160_CP001397-gene_783-gene_806",2540348160,783,806,869910,890666,20756
"2540348160_CP001397-gene_2886-gene_3002",2540348160,2886,3002,3307119,3434800,127681
"2540348160_CP001397-gene_2556-gene_2669",2540348160,2556,2669,2941719,3067077,125358
"2540348160_CP001397-gene_208-gene_273",2540348160,208,273,269200,338223,69023
"2540348160_CP001397-gene_592-gene_685",2540348160,592,685,678526,760688,82162
"650716068_NC_015458-gene_209-gene_304",650716068,209,304,243624,372854,129230
"2503755728_Ddes_Contig54-gene_2498-gene_2537",2503755728,2498,2537,2718908,2774854,55946
"641522729_NC_010674-gene_1541-gene_1594",641522729,1541,1594,1662386,1715425,53039
"639633066_NC_008571-gene_2377-gene_2446",639633066,2377,2446,2682923,2758772,75849
"639633066_NC_008571-gene_797-gene_845",639633066,797,845,947451,993402,45951
"2556981731_CP006939-gene_612-gene_659",2556981731,612,659,693062,736116,43054
"2556981731_CP006939-gene_2915-gene_3011",2556981731,2915,3011,3313349,3430421,117072
"2690318780_Ga0045920_11-gene_1547-gene_1599",2690318780,1547,1599,1663315,1716101,52786
"2667536837_Ga0104699_11-gene_7-gene_79",2667536837,7,79,6118,89812,83694
"2667536837_Ga0104699_11-gene_1934-gene_1962",2667536837,1934,1962,2084320,2114365,30045
"646564593_NC_014008-gene_266-gene_307",646564593,266,307,357993,383617,25624
"646564593_NC_014008-gene_1988-gene_2006",646564593,1988,2006,2472434,2528606,56172
"646564593_NC_014008-gene_540-gene_562",646564593,540,562,723636,738849,15213
"646564593_NC_014008-gene_3018-gene_3039",646564593,3018,3039,3694872,3709458,14586
"2540348203_FO203427-gene_1208-gene_1305",2540348203,1208,1305,1332685,1409566,76881
"647533454_NZ_DS989898-gene_1565-gene_1654",647533454,1565,1654,1607913,1703106,95193
"647533454_NZ_DS989898-gene_3061-gene_3126",647533454,3061,3126,3144119,3191163,47044
"2596648949_LY87DRAFT_unitig_0_quiver_1-gene_3027-gene_3090",2596648949,3027,3090,3425272,3497000,71728
"2596648949_LY87DRAFT_unitig_0_quiver_1-gene_1984-gene_2095",2596648949,1984,2095,2235835,2351633,115798
"2511051433_CP002901-gene_385-gene_538",2511051433,385,538,395264,537992,142728
"2511051433_CP002901-gene_2995-gene_3110",2511051433,2995,3110,2887013,2970878,83865
"2511051433_CP002901-gene_2025-gene_2117",2511051433,2025,2117,1986387,2061217,74830
"2511051433_CP002901-gene_2545-gene_2686",2511051433,2545,2686,2464892,2573542,108650
"646311903_NC_013222-gene_2004-gene_2051",646311903,2004,2051,2313157,2350122,36965
"646311903_NC_013222-gene_201-gene_233",646311903,201,233,250985,281140,30155
"2724812732_K10K4_chromosome1-gene_1339-gene_1363",2724812732,1339,1363,1481535,1498667,17132
"2724812732_K10K4_chromosome1-gene_1758-gene_1857",2724812732,1758,1857,1951163,2063015,111852
"637000420_NC_007484-gene_386-gene_472",637000420,386,472,423923,489818,65895
"2724812413_K04M3_chromosome1-gene_1373-gene_1397",2724812413,1373,1397,1508151,1525283,17132
"2724812413_K04M3_chromosome1-gene_1784-gene_1883",2724812413,1784,1883,1970202,2082054,111852
"2724812419_K05K4_chromosome1-gene_1361-gene_1385",2724812419,1361,1385,1497978,1515110,17132
"2724812419_K05K4_chromosome1-gene_1785-gene_1884",2724812419,1785,1884,1967607,2079458,111851
"2724812408_K04M1_chromosome1-gene_1370-gene_1394",2724812408,1370,1394,1503811,1520943,17132
"2724812408_K04M1_chromosome1-gene_1777-gene_1877",2724812408,1777,1877,1965862,2077714,111852
"2724812723_K06K5_chromosome1-gene_1371-gene_1395",2724812723,1371,1395,1503287,1520419,17132
"2724812723_K06K5_chromosome1-gene_1777-gene_1876",2724812723,1777,1876,1965338,2077190,111852
"2724812416_K04M5_chromosome1-gene_1765-gene_1865",2724812416,1765,1865,1963657,2075509,111852
"2724812416_K04M5_chromosome1-gene_1337-gene_1361",2724812416,1337,1361,1481536,1498668,17132
"2724812406_K01M1_chromosome1-gene_1769-gene_1868",2724812406,1769,1868,1962332,2074184,111852
"2724812406_K01M1_chromosome1-gene_1363-gene_1387",2724812406,1363,1387,1500281,1517413,17132
"2724812734_K08M3_chromosome1-gene_1360-gene_1384",2724812734,1360,1384,1498822,1515954,17132
"2724812734_K08M3_chromosome1-gene_1770-gene_1870",2724812734,1770,1870,1960873,2072725,111852
"2724812731_K09K1_contig000002-gene_192-gene_216",2724812731,192,216,214660,231792,17132
"2724812731_K09K1_contig000002-gene_2779-gene_2877",2724812731,2779,2877,3110919,3219335,108416
"2718228555_Ga0175862_11-gene_817-gene_837",2718228555,817,837,810165,828036,17871
"650716118_NC_015638-gene_2872-gene_2918",650716118,2872,2918,3187557,3228555,40998
"2549075848_RCA23c-gene_1269-gene_1366",2549075848,1269,1366,1323803,1426939,103136
"2504643033_SYNPCC8807DRAFT_8807_chromosome-gene_80-gene_98",2504643033,80,98,94011,104165,10154
"2504643047_SYNPCC73109DRAFT_73109_chromosome-gene_1788-gene_1815",2504643047,1788,1815,2000010,2028458,28448
"2504643047_SYNPCC73109DRAFT_73109_chromosome-gene_1921-gene_1942",2504643047,1921,1942,2155308,2167710,12402
"646311952_NC_013456-gene_1539-gene_1644",646311952,1539,1644,1746774,1849178,102404
"2718228224_Ga0176053_11-gene_1461-gene_1516",2718228224,1461,1516,1451904,1497385,45481
"2718228346_Ga0175161_11-gene_1608-gene_1701",2718228346,1608,1701,1845504,1923206,77702
"2721801511_Ga0175657_12-gene_2685-gene_2714",2721801511,2685,2714,2702606,2726565,23959
"2663809665_Ga0114161_11-gene_1830-gene_1843",2663809665,1830,1843,2068306,2079871,11565
"2663809665_Ga0114161_11-gene_533-gene_627",2663809665,533,627,606913,709125,102212
"2526170607_CA2559_HTCC2559_1-gene_53-gene_93",2526170607,53,93,85933,123820,37887
"648028061_NC_014414-gene_2294-gene_2320",648028061,2294,2320,2476066,2504856,28790
"648028061_NC_014414-gene_1047-gene_1130",648028061,1047,1130,1104336,1199278,94942
"2622780069_CP011373-gene_873-gene_915",2622780069,873,915,939171,981858,42687
"2622780069_CP011373-gene_56-gene_93",2622780069,56,93,47110,78742,31632
"647535429_NZ_GG704599-gene_222-gene_240",647535429,222,240,222002,243554,21552
"647533516_NZ_DS990556-gene_2410-gene_2507",647533516,2410,2507,2403035,2503079,100044
"2507267694_KS100_Contig_1-gene_1550-gene_1564",2507267694,1550,1564,1551271,1560320,9049
"2507267694_KS100_Contig_1-gene_1083-gene_1181",2507267694,1083,1181,1070014,1156405,86391
"2507267694_KS100_Contig_1-gene_1733-gene_1831",2507267694,1733,1831,1708012,1777854,69842
"2507267694_KS100_Contig_1-gene_2360-gene_2459",2507267694,2360,2459,2275983,2360575,84592
"2507267694_KS100_Contig_1-gene_1651-gene_1717",2507267694,1651,1717,1642710,1698526,55816
"2507267694_KS100_Contig_1-gene_627-gene_665",2507267694,627,665,653723,686458,32735
"646564595_NC_014010-gene_1727-gene_1753",646564595,1727,1753,1853620,1880413,26793
"2513265731_NZ_AGIF02000001-gene_1886-gene_1902",2513265731,1886,1902,2087139,2097722,10583
"2507281848_Syn8016_Contig50_1-gene_297-gene_400",2507281848,297,400,248809,335127,86318
"2507281848_Syn8016_Contig50_1-gene_1207-gene_1278",2507281848,1207,1278,1136273,1192649,56376
"2507281848_Syn8016_Contig50_1-gene_33-gene_80",2507281848,33,80,30082,61332,31250
"2507281848_Syn8016_Contig50_1-gene_494-gene_593",2507281848,494,593,422160,523844,101684
"2507281848_Syn8016_Contig50_1-gene_2667-gene_2690",2507281848,2667,2690,2586837,2600341,13504
"2507281848_Syn8016_Contig50_1-gene_125-gene_224",2507281848,125,224,108021,183191,75170
"2507281848_Syn8016_Contig50_1-gene_2305-gene_2399",2507281848,2305,2399,2239804,2334181,94377
"640069312_NC_008820-gene_1641-gene_1710",640069312,1641,1710,1786097,1864949,78852
"640069312_NC_008820-gene_244-gene_322",640069312,244,322,284900,378422,93522
"640069312_NC_008820-gene_936-gene_1035",640069312,936,1035,1013875,1109970,96095
"640069312_NC_008820-gene_847-gene_912",640069312,847,912,918930,986846,67916
"2509602057_Halha_Contig26_1-gene_1232-gene_1253",2509602057,1232,1253,1274933,1288280,13347
"2509602057_Halha_Contig26_1-gene_1873-gene_1921",2509602057,1873,1921,1953601,1984022,30421
"650716048_NC_015391-gene_65-gene_163",650716048,65,163,71999,152397,80398
"650716048_NC_015391-gene_866-gene_897",650716048,866,897,914974,934565,19591
"637000608_NC_008319-gene_2126-gene_2162",637000608,2126,2162,2112266,2144903,32637
"637000608_NC_008319-gene_1551-gene_1652",637000608,1551,1652,1573811,1656493,82682
"637000608_NC_008319-gene_957-gene_1015",637000608,957,1015,966208,1024539,58331
"637000608_NC_008319-gene_2428-gene_2526",637000608,2428,2526,2417975,2517479,99504
"637000608_NC_008319-gene_558-gene_657",637000608,558,657,578864,668318,89454
"637000608_NC_008319-gene_716-gene_809",637000608,716,809,729363,808899,79536
"2517287732_B044DRAFT_scaffold1_1-gene_77-gene_121",2517287732,77,121,78702,110555,31853
"2507267692_KS49_KORDI_49_1-gene_1041-gene_1136",2507267692,1041,1136,1092817,1166620,73803
"2507267692_KS49_KORDI_49_1-gene_789-gene_843",2507267692,789,843,822472,858847,36375
"2507267692_KS49_KORDI_49_1-gene_1148-gene_1217",2507267692,1148,1217,1174997,1221733,46736
"2507267692_KS49_KORDI_49_1-gene_1739-gene_1755",2507267692,1739,1755,1736079,1747397,11318
"2507267692_KS49_KORDI_49_1-gene_2109-gene_2199",2507267692,2109,2199,2113072,2197794,84722
"2576887216_P163DRAFT_scf7180000000039_quiver_5-gene_969-gene_1028",2576887216,969,1028,1095440,1152405,56965
"2576887216_P163DRAFT_scf7180000000039_quiver_5-gene_2212-gene_2298",2576887216,2212,2298,2444487,2546222,101735
"2507267693_KS52_KORDI_52_1-gene_513-gene_541",2507267693,513,541,506126,526034,19908
"2507267693_KS52_KORDI_52_1-gene_1479-gene_1578",2507267693,1479,1578,1402028,1465532,63504
"2507267693_KS52_KORDI_52_1-gene_2069-gene_2111",2507267693,2069,2111,1935128,1973421,38293
"2507267693_KS52_KORDI_52_1-gene_1703-gene_1747",2507267693,1703,1747,1578653,1613693,35040
"2507267693_KS52_KORDI_52_1-gene_986-gene_1073",2507267693,986,1073,944688,1025271,80583
"2507267693_KS52_KORDI_52_1-gene_1245-gene_1272",2507267693,1245,1272,1188696,1209309,20613
"2507267693_KS52_KORDI_52_1-gene_1871-gene_1934",2507267693,1871,1934,1737091,1793207,56116
"2507267693_KS52_KORDI_52_1-gene_763-gene_810",2507267693,763,810,720704,778258,57554
"640753031_NC_009663-gene_717-gene_808",640753031,717,808,721446,799971,78525
"640753031_NC_009663-gene_2078-gene_2108",640753031,2078,2108,2086610,2113648,27038
"2509292655_ThesiDRAFT_TSF_1-gene_932-gene_1033",2509292655,932,1033,878124,968801,90677
"2718228072_Ga0174827_11-gene_1264-gene_1293",2718228072,1264,1293,1337568,1351588,14020
"637000441_NC_007516-gene_2596-gene_2707",637000441,2596,2707,2284116,2395236,111120
"637000441_NC_007516-gene_969-gene_1002",637000441,969,1002,896600,920504,23904
"637000441_NC_007516-gene_1546-gene_1648",637000441,1546,1648,1389679,1452292,62613
"637000441_NC_007516-gene_1283-gene_1297",637000441,1283,1297,1152783,1159946,7163
"637000441_NC_007516-gene_1872-gene_1892",637000441,1872,1892,1623201,1638284,15083
"637000441_NC_007516-gene_1720-gene_1755",637000441,1720,1755,1522910,1544433,21523
"637000441_NC_007516-gene_1086-gene_1155",637000441,1086,1155,992705,1036199,43494
"637000441_NC_007516-gene_1976-gene_2039",637000441,1976,2039,1708133,1756052,47919
"638366418_NZ_AANA01000001-gene_1438-gene_1454",638366418,1438,1454,1643207,1659911,16704
