"Fragment","Scaffold.ID","Gene.Start","Gene.End","bp.Start","bp.End","Fragment.Length"
"2526166977_SER39009_Serratia_39006_draft_12-05-13_1-gene_2588-gene_2649",2526166977,2588,2649,2875271,2917328,42057
"2518681435_CP003677-gene_1360-gene_1411",2518681435,1360,1411,1476813,1516770,39957
"2519109854_F550DRAFT_scaffold00001_1-circular-gene_1023-gene_1044",2519109854,1023,1044,1051578,1072189,20611
"2519109854_F550DRAFT_scaffold00001_1-circular-gene_1078-gene_1151",2519109854,1078,1151,1107150,1177467,70317
"647533937_NZ_DS999412-circular-gene_187-gene_234",647533937,187,234,168264,205394,37130
"647533937_NZ_DS999412-circular-gene_1749-gene_1810",647533937,1749,1810,1907646,1969070,61424
"647533937_NZ_DS999412-circular-gene_3956-gene_3984",647533937,3956,3984,4300099,4322413,22314
"647533937_NZ_DS999412-circular-gene_0-gene_50",647533937,0,50,5013276,30348,-4982928
"647533937_NZ_DS999412-circular-gene_2641-gene_2698",647533937,2641,2698,2882543,2942386,59843
"647533937_NZ_DS999412-circular-gene_905-gene_972",647533937,905,972,977246,1027291,50045
"647533937_NZ_DS999412-circular-gene_4032-gene_4081",647533937,4032,4081,4379596,4410368,30772
"647533937_NZ_DS999412-circular-gene_1912-gene_1937",647533937,1912,1937,2072413,2090605,18192
"2516493516_NitteDRAFT_scaffold1_1-circular-gene_1828-gene_1876",2516493516,1828,1876,1757417,1802060,44643
"650377989_CP002377-circular-gene_2404-gene_2451",650377989,2404,2451,2595958,2633110,37152
"2517093774_Syn9616DRAFT_scaffold1_1-circular-gene_431-gene_530",2517093774,431,530,385623,463513,77890
"647010922_NZ_ACZV01000004-circular-gene_818-gene_861",647010922,818,861,929076,962050,32974
"2540355318_H276DRAFT_scaffold00001_1-circular-gene_725-gene_751",2540355318,725,751,751709,773444,21735
"2630977688_Ga0081189_11-circular-gene_398-gene_473",2630977688,398,473,408675,487078,78403
"2524708640_K337DRAFT_scaffold00002_2-circular-gene_199-gene_268",2524708640,199,268,216587,270640,54053
"2524708640_K337DRAFT_scaffold00002_2-circular-gene_776-gene_848",2524708640,776,848,811492,867042,55550
"643692038_NC_012440-circular-gene_1738-gene_1798",643692038,1738,1798,1717883,1754803,36920
"646311943_NC_013440-gene_1014-gene_1111",646311943,1014,1111,1278302,1397784,119482
"646311943_NC_013440-gene_584-gene_803",646311943,584,803,774298,1031155,256857
"646311943_NC_013440-gene_821-gene_850",646311943,821,850,1071620,1101869,30249
"650716148_NC_015711-gene_5117-gene_5198",650716148,5117,5198,5952754,6025098,72344
"650716148_NC_015711-gene_7454-gene_7495",650716148,7454,7495,8946978,8987499,40521
"650716148_NC_015711-gene_3723-gene_3820",650716148,3723,3820,4307581,4397533,89952
"637000467_NC_007645-gene_329-gene_378",637000467,329,378,380499,423375,42876
"637000467_NC_007645-gene_6132-gene_6174",637000467,6132,6174,6863337,6900524,37187
"637000467_NC_007645-gene_4105-gene_4142",637000467,4105,4142,4658441,4689647,31206
"637000467_NC_007645-gene_5070-gene_5165",637000467,5070,5165,5730149,5820562,90413
"637000467_NC_007645-gene_2579-gene_2678",637000467,2579,2678,2918487,2994677,76190
"643692052_NC_012490-gene_2276-gene_2334",643692052,2276,2334,2444253,2488197,43944
"643692052_NC_012490-gene_2510-gene_2597",643692052,2510,2597,2668810,2727185,58375
"2718228132_Ga0175156_11-gene_1968-gene_2025",2718228132,1968,2025,2142757,2193556,50799
"2506485008_Contig317-gene_863-gene_960",2506485008,863,960,1011820,1090999,79179
"643348578_NC_011566-gene_2273-gene_2282",643348578,2273,2282,2690277,2700247,9970
"641228507_NC_009997-gene_2143-gene_2194",641228507,2143,2194,2526485,2571522,45037
"641228507_NC_009997-gene_2263-gene_2355",641228507,2263,2355,2649580,2731034,81454
"641228507_NC_009997-gene_771-gene_828",641228507,771,828,902045,946782,44737
"641228507_NC_009997-gene_2938-gene_2986",641228507,2938,2986,3439806,3477767,37961
"2631013058_Ga0046381_11-gene_770-gene_828",2631013058,770,828,900951,945080,44129
"2631013058_Ga0046381_11-gene_2879-gene_2918",2631013058,2879,2918,3389466,3420793,31327
"2631013058_Ga0046381_11-gene_2102-gene_2153",2631013058,2102,2153,2485996,2531033,45037
"651053104_CP002811-gene_2305-gene_2342",651053104,2305,2342,2611244,2640589,29345
"651053104_CP002811-gene_1369-gene_1427",651053104,1369,1427,1546333,1586911,40578
"651053104_CP002811-gene_3763-gene_3823",651053104,3763,3823,4303951,4352302,48351
"640753033_NC_009665-gene_734-gene_792",640753033,734,792,865059,908266,43207
"640753033_NC_009665-gene_2114-gene_2167",640753033,2114,2167,2481131,2527824,46693
"641522617_NC_010334-gene_1313-gene_1365",641522617,1313,1365,1581117,1619476,38359
"2512564983_OA238_c-gene_4348-gene_4433",2512564983,4348,4433,4048829,4116476,67647
"2524037964_FO203503-gene_4414-gene_4444",2524037964,4414,4444,5035903,5064438,28535
"637000580_NC_008228-gene_681-gene_746",637000580,681,746,774567,837454,62887
"2728434717_Ga0175483_11-gene_3929-gene_4004",2728434717,3929,4004,3999581,4061820,62239
"2728434717_Ga0175483_11-gene_2295-gene_2331",2728434717,2295,2331,2291346,2324472,33126
"2728434717_Ga0175483_11-gene_4898-gene_4949",2728434717,4898,4949,4980683,5024148,43465
"643348595_NC_011663-gene_757-gene_814",643348595,757,814,882667,925947,43280
"643348595_NC_011663-gene_2587-gene_2664",643348595,2587,2664,3056036,3116455,60419
"2507281626_Sbal625_Contig118_1-gene_2046-gene_2094",2507281626,2046,2094,2452419,2497104,44685
"2507281626_Sbal625_Contig118_1-gene_2172-gene_2219",2507281626,2172,2219,2588967,2627708,38741
"640069332_NC_009052-gene_2223-gene_2256",640069332,2223,2256,2512323,2542729,30406
"640069332_NC_009052-gene_1283-gene_1342",640069332,1283,1342,1444815,1486320,41505
"640069332_NC_009052-gene_3681-gene_3735",640069332,3681,3735,4211115,4254676,43561
"2513256208_cola_cola-finished-ohne-overlap_screen_ace_1_1-gene_1656-gene_1755",2513256208,1656,1755,1923837,2020467,96630
"2718228709_Ga0175363_11-gene_986-gene_1083",2718228709,986,1083,1319453,1390860,71407
"2718228709_Ga0175363_11-gene_1767-gene_1809",2718228709,1767,1809,2260457,2290543,30086
"2643222989_Cab_131026-gene_190-gene_232",2643222989,190,232,236802,266888,30086
"2643222989_Cab_131026-gene_3237-gene_3334",2643222989,3237,3334,4274339,4345746,71407
"2561539978_Calab_Cab_131026_1-gene_1767-gene_1809",2561539978,1767,1809,2260457,2290543,30086
"2561539978_Calab_Cab_131026_1-gene_986-gene_1083",2561539978,986,1083,1319453,1390860,71407
"646564597_NC_014012-gene_2011-gene_2037",646564597,2011,2037,2512185,2528729,16544
"2526166977_SER39009_Serratia_39006_draft_12-05-13_1-gene_2475-gene_2515",2526166977,2475,2515,2763218,2797702,34484
"2526166977_SER39009_Serratia_39006_draft_12-05-13_1-gene_4119-gene_4180",2526166977,4119,4180,4658820,4703210,44390
"2524031326_Shewanella-gene_1665-gene_1720",2524031326,1665,1720,1952220,1998477,46257
"2619690354_Ga0074067_11-gene_1683-gene_1739",2619690354,1683,1739,1867246,1907731,40485
"2619690354_Ga0074067_11-gene_3758-gene_3822",2619690354,3758,3822,4032892,4086706,53814
"2619690354_Ga0074067_11-gene_3009-gene_3089",2619690354,3009,3089,3250283,3318961,68678
"637000611_NC_008322-gene_717-gene_769",637000611,717,769,819483,855165,35682
"644736375_NC_012850-gene_824-gene_862",644736375,824,862,839230,862842,23612
"639633068_NC_008576-gene_2965-gene_3064",639633068,2965,3064,3537766,3618086,80320
"639633068_NC_008576-gene_2858-gene_2957",639633068,2858,2957,3453930,3533133,79203
"639633068_NC_008576-gene_1735-gene_1805",639633068,1735,1805,2060848,2128708,67860
"639633068_NC_008576-gene_2687-gene_2786",639633068,2687,2786,3267841,3358184,90343
"639633068_NC_008576-gene_1321-gene_1419",639633068,1321,1419,1548771,1631075,82304
"639633068_NC_008576-gene_2092-gene_2188",639633068,2092,2188,2482937,2569493,86556
"650716032_NC_015275-gene_951-gene_1022",650716032,951,1022,1097422,1137768,40346
"650716032_NC_015275-gene_2749-gene_2844",650716032,2749,2844,2984437,3049840,65403
"650716032_NC_015275-gene_750-gene_858",650716032,750,858,922403,1007854,85451
"650716032_NC_015275-gene_1849-gene_1912",650716032,1849,1912,2051269,2090332,39063
"650716032_NC_015275-gene_879-gene_928",650716032,879,928,1029939,1074532,44593
"650716032_NC_015275-gene_1197-gene_1217",650716032,1197,1217,1346365,1365519,19154
"639633107_NC_008750-gene_2480-gene_2560",639633107,2480,2560,2832008,2887378,55370
"639633107_NC_008750-gene_2904-gene_2975",639633107,2904,2975,3308788,3365148,56360
"2506213072_Contig398-gene_4176-gene_4195",2506213072,4176,4195,4652481,4664967,12486
"2506213072_Contig398-gene_1804-gene_1865",2506213072,1804,1865,2005664,2053485,47821
"2524031327_Shewanella-gene_3320-gene_3369",2524031327,3320,3369,3865190,3906314,41124
"2517487235_scaffold00006-gene_2798-gene_2848",2517487235,2798,2848,2825633,2870622,44989
"2517487235_scaffold00006-gene_2294-gene_2391",2517487235,2294,2391,2349298,2426553,77255
"2521194441_CP003845-gene_2449-gene_2500",2521194441,2449,2500,2891581,2933581,42000
"650377919_CP001978-gene_644-gene_704",650377919,644,704,671039,713786,42747
"650377919_CP001978-gene_1950-gene_2019",650377919,1950,2019,2063045,2112022,48977
"642555224_NC_011138-gene_754-gene_825",642555224,754,825,834034,889750,55716
"2597512639_Ga0036914_gi564132530_1-gene_1144-gene_1181",2597512639,1144,1181,1237366,1278473,41107
"2597512639_Ga0036914_gi564132530_1-gene_2218-gene_2230",2597512639,2218,2230,2399994,2408175,8181
"2512571803_NC_016940-gene_561-gene_646",2512571803,561,646,724728,841835,117107
"2721800935_Ga0175699_12-gene_1067-gene_1088",2721800935,1067,1088,1126960,1143473,16513
"2721800935_Ga0175699_12-gene_2045-gene_2143",2721800935,2045,2143,2118875,2221497,102622
"2521191475_Leiaq_neu_scaffold_2516677483_1-gene_3152-gene_3200",2521191475,3152,3200,3220661,3258158,37497
"2521191523_Phaar_neu_scaffold_2516677464_1-gene_2349-gene_2394",2521191523,2349,2394,2442235,2475318,33083
"2521191523_Phaar_neu_scaffold_2516677464_1-gene_2113-gene_2204",2521191523,2113,2204,2203286,2280615,77329
"2521191523_Phaar_neu_scaffold_2516677464_1-gene_1-gene_82",2521191523,1,82,0,63298,63298
"2521191523_Phaar_neu_scaffold_2516677464_1-gene_1517-gene_1561",2521191523,1517,1561,1606892,1639329,32437
"2521191523_Phaar_neu_scaffold_2516677464_1-gene_2017-gene_2055",2521191523,2017,2055,2116226,2145392,29166
"2512569605_Leime_Contig76_3-gene_2139-gene_2184",2512569605,2139,2184,2141757,2177757,36000
"2512569605_Leime_Contig76_3-gene_3039-gene_3094",2512569605,3039,3094,3066207,3120558,54351
"2512569605_Leime_Contig76_3-gene_1289-gene_1360",2512569605,1289,1360,1295144,1345745,50601
"2512569605_Leime_Contig76_3-gene_1786-gene_1861",2512569605,1786,1861,1791364,1854045,62681
"2687454401_Ga0133388_11-gene_2609-gene_2695",2687454401,2609,2695,2734000,2804434,70434
"2687454401_Ga0133388_11-gene_3574-gene_3703",2687454401,3574,3703,3767093,3870941,103848
"2687454401_Ga0133388_11-gene_2030-gene_2133",2687454401,2030,2133,2113000,2200809,87809
"2667542047_Ga0105927_11-gene_3574-gene_3693",2667542047,3574,3693,3771957,3868806,96849
"2667542047_Ga0105927_11-gene_2039-gene_2135",2667542047,2039,2135,2116931,2199626,82695
"2667542047_Ga0105927_11-gene_2614-gene_2700",2667542047,2614,2700,2737904,2808661,70757
"2622780072_scf7180000000004-gene_1974-gene_2082",2622780072,1974,2082,2351852,2463266,111414
"637000159_NC_003911-gene_1040-gene_1075",637000159,1040,1075,1080764,1105118,24354
"2558913391_P176DRAFT_scf7180000000002_quiver_dupTrim_6579_1-gene_2375-gene_2437",2558913391,2375,2437,2766915,2814914,47999
"637000312_NC_006370-gene_1312-gene_1372",637000312,1312,1372,1478766,1530840,52074
"646564576_NC_013960-gene_927-gene_1037",646564576,927,1037,950180,1034729,84549
"2512205695_CP002987-gene_3164-gene_3224",2512205695,3164,3224,3568170,3601737,33567
"2512205695_CP002987-gene_3566-gene_3646",2512205695,3566,3646,3955988,4009903,53915
"2667542034_Ga0114080_11-gene_2639-gene_2706",2667542034,2639,2706,2264364,2311513,47149
"647533596_NZ_DS995276-gene_3292-gene_3380",647533596,3292,3380,3190921,3271406,80485
"2511244427_NC_016078-gene_672-gene_764",2511244427,672,764,676603,756211,79608
"2511244427_NC_016078-gene_909-gene_925",2511244427,909,925,916135,932318,16183
"2667541935_Ga0102658_12-gene_1305-gene_1353",2667541935,1305,1353,1485562,1523601,38039
"2597520218_Ga0032872_gi461490773_1-gene_433-gene_482",2597520218,433,482,506714,540004,33290
"2645768409_Ga0069294_12-gene_1623-gene_1692",2645768409,1623,1692,1857872,1903738,45866
"650716102_NC_015590-gene_220-gene_295",650716102,220,295,257833,314278,56445
"650716102_NC_015590-gene_2233-gene_2317",650716102,2233,2317,2288740,2355208,66468
"650716102_NC_015590-gene_1342-gene_1435",650716102,1342,1435,1377451,1449441,71990
"650716102_NC_015590-gene_750-gene_840",650716102,750,840,790860,851832,60972
"650716102_NC_015590-gene_1805-gene_1848",650716102,1805,1848,1841924,1873068,31144
"641522729_NC_010674-gene_2172-gene_2223",641522729,2172,2223,2330638,2362484,31846
"641522729_NC_010674-gene_2627-gene_2721",641522729,2627,2721,2811229,2873956,62727
"641522729_NC_010674-gene_2305-gene_2329",641522729,2305,2329,2463246,2485896,22650
"641522729_NC_010674-gene_2639-gene_2758",641522729,2639,2758,2821307,2905513,84206
"641522729_NC_010674-gene_23-gene_41",641522729,23,41,31919,46702,14783
"641522729_NC_010674-gene_866-gene_913",641522729,866,913,940048,971381,31333
"641522729_NC_010674-gene_1816-gene_1896",641522729,1816,1896,1979655,2030044,50389
"639633066_NC_008571-gene_2228-gene_2314",639633066,2228,2314,2547178,2605024,57846
"647533810_NZ_DS999213-gene_3456-gene_3479",647533810,3456,3479,3580544,3600594,20050
"2690318780_Ga0045920_11-gene_2646-gene_2776",2690318780,2646,2776,2813381,2906474,93093
"2690318780_Ga0045920_11-gene_2644-gene_2739",2690318780,2644,2739,2812189,2874917,62728
"2690318780_Ga0045920_11-gene_24-gene_42",2690318780,24,42,32369,47152,14783
"2690318780_Ga0045920_11-gene_1827-gene_1921",2690318780,1827,1921,1980589,2046533,65944
"2690318780_Ga0045920_11-gene_2318-gene_2342",2690318780,2318,2342,2464182,2486832,22650
"2690318780_Ga0045920_11-gene_872-gene_919",2690318780,872,919,940977,972310,31333
"2690318780_Ga0045920_11-gene_2185-gene_2236",2690318780,2185,2236,2331572,2363418,31846
"2690318780_Ga0045920_11-gene_1827-gene_1905",2690318780,1827,1905,1980589,2028290,47701
"640753071_NC_009783-gene_2102-gene_2117",640753071,2102,2117,2303631,2317096,13465
"640753071_NC_009783-gene_1736-gene_1834",640753071,1736,1834,1932927,2015928,83001
"2561541728_CP006605-gene_661-gene_756",2561541728,661,756,713619,794086,80467
"2561541728_CP006605-gene_373-gene_388",2561541728,373,388,413900,427365,13465
"637000620_NC_008358-gene_2448-gene_2531",637000620,2448,2531,2600270,2709098,108828
"2648578723_Ga0045936_12-gene_2016-gene_2109",2648578723,2016,2109,2296214,2377697,81483
"2648578723_Ga0045936_12-gene_1412-gene_1459",2648578723,1412,1459,1609295,1664601,55306
"2648578723_Ga0045936_12-gene_1323-gene_1352",2648578723,1323,1352,1515663,1536111,20448
"2540348203_FO203427-gene_2260-gene_2352",2540348203,2260,2352,2474726,2569803,95077
"647533454_NZ_DS989898-gene_1834-gene_1924",647533454,1834,1924,1883599,1963166,79567
"637000172_NC_004193-gene_158-gene_257",637000172,158,257,165610,280244,114634
"637000323_NC_006510-gene_498-gene_574",637000323,498,574,538104,581745,43641
"646311903_NC_013222-gene_2691-gene_2741",646311903,2691,2741,3087155,3128656,41501
"637000284_NC_006138-gene_1986-gene_2086",637000284,1986,2086,2255392,2373762,118370
"637000284_NC_006138-gene_1537-gene_1593",637000284,1537,1593,1735086,1787735,52649
"2512211939_PhacaeDRAFT_Scaffold1_6-gene_2735-gene_2790",2512211939,2735,2790,2857205,2898302,41097
"2512211939_PhacaeDRAFT_Scaffold1_6-gene_1-gene_35",2512211939,1,35,0,21245,21245
"2512211939_PhacaeDRAFT_Scaffold1_6-gene_3312-gene_3405",2512211939,3312,3405,3455437,3520745,65308
"2724812732_K10K4_chromosome1-gene_1209-gene_1253",2724812732,1209,1253,1355664,1393405,37741
"2724812732_K10K4_chromosome1-gene_1531-gene_1545",2724812732,1531,1545,1699845,1710218,10373
"2724812413_K04M3_chromosome1-gene_1209-gene_1253",2724812413,1209,1253,1355665,1393406,37741
"2724812419_K05K4_chromosome1-gene_1231-gene_1275",2724812419,1231,1275,1372107,1409848,37741
"2724812419_K05K4_chromosome1-gene_1556-gene_1571",2724812419,1556,1571,1716288,1726661,10373
"2724812408_K04M1_chromosome1-gene_1240-gene_1284",2724812408,1240,1284,1377940,1415681,37741
"2724812723_K06K5_chromosome1-gene_1241-gene_1285",2724812723,1241,1285,1377416,1415157,37741
"2724812416_K04M5_chromosome1-gene_1207-gene_1251",2724812416,1207,1251,1355665,1393406,37741
"2724812406_K01M1_chromosome1-gene_1233-gene_1277",2724812406,1233,1277,1374410,1412151,37741
"2724812734_K08M3_chromosome1-gene_1230-gene_1274",2724812734,1230,1274,1372951,1410692,37741
"2724812731_K09K1_contig000002-gene_3087-gene_3096",2724812731,3087,3096,3459391,3465668,6277
"2724812731_K09K1_contig000002-gene_302-gene_346",2724812731,302,346,319923,357665,37742
"2724812731_K09K1_contig000002-gene_1-gene_23",2724812731,1,23,415,13479,13064
"2718228555_Ga0175862_11-gene_1409-gene_1459",2718228555,1409,1459,1405091,1454648,49557
"2718228555_Ga0175862_11-gene_3261-gene_3359",2718228555,3261,3359,3323083,3421618,98535
"2627905620_Ga0077997_11-gene_2471-gene_2532",2627905620,2471,2532,2479190,2523479,44289
"637000619_NC_008347-gene_924-gene_981",637000619,924,981,987133,1049218,62085
"642555204_NC_011026-gene_256-gene_320",642555204,256,320,303948,374029,70081
"2549075848_RCA23c-gene_2282-gene_2353",2549075848,2282,2353,2370338,2440463,70125
"646311952_NC_013456-gene_1807-gene_1820",646311952,1807,1820,2034045,2047922,13877
"637000417_NC_007481-gene_1433-gene_1478",637000417,1433,1478,1587400,1623178,35778
"643348691_NC_011963-gene_1433-gene_1455",643348691,1433,1455,1490364,1505906,15542
"643348691_NC_011963-gene_2992-gene_3036",643348691,2992,3036,3083285,3117660,34375
"643348691_NC_011963-gene_323-gene_394",643348691,323,394,325768,378487,52719
"2718228560_Ga0175864_11-gene_679-gene_734",2718228560,679,734,786863,827832,40969
"2627853750_Ga0079189_11-gene_1061-gene_1110",2627853750,1061,1110,1105716,1138982,33266
"2627853750_Ga0079189_11-gene_2109-gene_2159",2627853750,2109,2159,2205281,2241253,35972
"2627853750_Ga0079189_11-gene_2401-gene_2446",2627853750,2401,2446,2505247,2537239,31992
"2627853750_Ga0079189_11-gene_2747-gene_2790",2627853750,2747,2790,2877000,2909885,32885
"2627853750_Ga0079189_11-gene_829-gene_853",2627853750,829,853,857046,874264,17218
"2627853750_Ga0079189_11-gene_2299-gene_2332",2627853750,2299,2332,2395450,2423005,27555
"2627853750_Ga0079189_11-gene_1311-gene_1407",2627853750,1311,1407,1354747,1431706,76959
"2627853750_Ga0079189_11-gene_728-gene_784",2627853750,728,784,764742,804560,39818
"647535429_NZ_GG704599-gene_2480-gene_2541",647535429,2480,2541,2530324,2588381,58057
"649633102_NC_014831-gene_11-gene_67",649633102,11,67,14888,59135,44247
"647533516_NZ_DS990556-gene_1296-gene_1378",647533516,1296,1378,1284195,1355092,70897
"647533516_NZ_DS990556-gene_624-gene_664",647533516,624,664,616306,656141,39835
"2507267694_KS100_Contig_1-gene_2693-gene_2762",2507267694,2693,2762,2613864,2685797,71933
"2507267694_KS100_Contig_1-gene_2020-gene_2098",2507267694,2020,2098,1950549,2021557,71008
"2507267694_KS100_Contig_1-gene_192-gene_273",2507267694,192,273,216670,305767,89097
"646564595_NC_014010-gene_370-gene_413",646564595,370,413,384275,424480,40205
"646564595_NC_014010-gene_2295-gene_2321",646564595,2295,2321,2466286,2488042,21756
"2718229246_Ga0175211_11-gene_1629-gene_1696",2718229246,1629,1696,1675102,1717632,42530
"2571071633_BS76DRAFT_scf7180000000002_quiver_dupTrim_10022_1-gene_509-gene_571",2571071633,509,571,529035,573034,43999
"2718228072_Ga0174827_11-gene_1031-gene_1050",2718228072,1031,1050,1110568,1127528,16960
"637000441_NC_007516-gene_532-gene_587",637000441,532,587,509902,552640,42738
"637000441_NC_007516-gene_1761-gene_1859",637000441,1761,1859,1548638,1615256,66618
"2571156966_P166DRAFT_scf7180000000008_quiver_2-gene_408-gene_460",2571156966,408,460,451582,487311,35729
"2681918801_Ga0111635_114-circular-gene_0-gene_13",2681918801,0,13,27333,12333,-15000
"2630977689_Ga0081190_11-gene_2458-gene_2557",2630977689,2458,2557,3430431,3580818,150387
"2630977689_Ga0081190_11-gene_4792-gene_4891",2630977689,4792,4891,6828725,6968914,140189
"2630977689_Ga0081190_11-gene_796-gene_924",2630977689,796,924,1066882,1247883,181001
"2630977689_Ga0081190_11-gene_6748-gene_6761",2630977689,6748,6761,9544825,9557968,13143
"2630977689_Ga0081190_11-gene_4520-gene_4618",2630977689,4520,4618,6461297,6571606,110309
"2630977684_Ga0081187_11-circular-gene_4673-gene_4770",2630977684,4673,4770,6375942,6483786,107844
"2630977684_Ga0081187_11-circular-gene_6413-gene_6428",2630977684,6413,6428,8680596,8693336,12740
"2630977684_Ga0081187_11-circular-gene_1118-gene_1216",2630977684,1118,1216,1512995,1631054,118059
"2630977684_Ga0081187_11-circular-gene_2393-gene_2490",2630977684,2393,2490,3213745,3331029,117284
"2630977684_Ga0081187_11-circular-gene_5613-gene_5707",2630977684,5613,5707,7606015,7719752,113737
"2630977684_Ga0081187_11-circular-gene_2685-gene_2781",2630977684,2685,2781,3623370,3752077,128707
"2519109854_F550DRAFT_scaffold00001_1-circular-gene_2034-gene_2061",2519109854,2034,2061,2094654,2118143,23489
"2537605091_AODW01000026-circular-gene_76-gene_93",2537605091,76,93,73462,85457,11995
"2519942254_C505DRAFT_scaffold00018_18-circular-gene_21-gene_80",2519942254,21,80,18482,64448,45966
"647533937_NZ_DS999412-circular-gene_3605-gene_3702",647533937,3605,3702,3939838,4028861,89023
"2675923119_Ga0104434_115-circular-gene_43-gene_152",2675923119,43,152,27608,123395,95787
"2627929999_Ga0072914_123-circular-gene_1-gene_17",2627929999,1,17,128,9898,9770
"2523241327_G578DRAFT_scaffold00006_6-circular-gene_16-gene_74",2523241327,16,74,9935,61595,51660
"2517093774_Syn9616DRAFT_scaffold1_1-circular-gene_2737-gene_2781",2517093774,2737,2781,2615499,2645261,29762
"2517093774_Syn9616DRAFT_scaffold1_1-circular-gene_6-gene_37",2517093774,6,37,5336,27908,22572
"2517093774_Syn9616DRAFT_scaffold1_1-circular-gene_831-gene_853",2517093774,831,853,779187,793750,14563
"2517093774_Syn9616DRAFT_scaffold1_1-circular-gene_1386-gene_1446",2517093774,1386,1446,1242481,1299998,57517
"2517093774_Syn9616DRAFT_scaffold1_1-circular-gene_1699-gene_1795",2517093774,1699,1795,1551370,1641898,90528
"2517093774_Syn9616DRAFT_scaffold1_1-circular-gene_1100-gene_1199",2517093774,1100,1199,1009048,1072615,63567
"2517093774_Syn9616DRAFT_scaffold1_1-circular-gene_1000-gene_1097",2517093774,1000,1097,933842,1006510,72668
"2551322073_A132DRAFT_AJYX01000047_1_47-circular-gene_10-gene_29",2551322073,10,29,12156,30399,18243
"2540355318_H276DRAFT_scaffold00001_1-circular-gene_3197-gene_3291",2540355318,3197,3291,3338204,3438247,100043
"2654625850_Ga0111158_1002-circular-gene_6-gene_110",2654625850,6,110,1887,56160,54273
"2524708640_K337DRAFT_scaffold00002_2-circular-gene_452-gene_553",2524708640,452,553,462969,554286,91317
"2718228070_Ga0174825_11-gene_1022-gene_1120",2718228070,1022,1120,1514764,1665151,150387
"2718228070_Ga0174825_11-gene_3669-gene_3682",2718228070,3669,3682,5210722,5223865,13143
"2718228070_Ga0174825_11-gene_5840-gene_5912",2718228070,5840,5912,8227928,8309646,81718
"2718228070_Ga0174825_11-gene_5539-gene_5638",2718228070,5539,5638,7799776,7939965,140189
"2718228070_Ga0174825_11-gene_2654-gene_2782",2718228070,2654,2782,3847699,4028700,181001
"646311943_NC_013440-gene_6693-gene_6791",646311943,6693,6791,9037566,9159864,122298
"646311943_NC_013440-gene_3076-gene_3185",646311943,3076,3185,4195889,4328135,132246
"646311943_NC_013440-gene_2884-gene_2983",646311943,2884,2983,3900389,4011359,110970
"646311943_NC_013440-gene_854-gene_992",646311943,854,992,1105403,1241803,136400
"646311943_NC_013440-gene_1566-gene_1665",646311943,1566,1665,2096300,2228050,131750
"646311943_NC_013440-gene_2613-gene_2719",646311943,2613,2719,3574267,3708734,134467
"646311943_NC_013440-gene_1223-gene_1305",646311943,1223,1305,1559422,1684047,124625
"646311943_NC_013440-gene_1131-gene_1193",646311943,1131,1193,1429988,1494345,64357
"646311943_NC_013440-gene_6459-gene_6525",646311943,6459,6525,8712981,8806605,93624
"646311943_NC_013440-gene_2764-gene_2860",646311943,2764,2860,3758664,3874905,116241
"650716148_NC_015711-gene_2069-gene_2147",650716148,2069,2147,2422786,2511960,89174
"650716148_NC_015711-gene_878-gene_1037",650716148,878,1037,1045169,1229481,184312
"650716148_NC_015711-gene_1881-gene_1988",650716148,1881,1988,2205341,2324485,119144
"650716148_NC_015711-gene_1364-gene_1462",650716148,1364,1462,1605066,1718126,113060
"650716148_NC_015711-gene_367-gene_466",650716148,367,466,431959,543900,111941
"650716148_NC_015711-gene_2496-gene_2595",650716148,2496,2595,2896446,3002988,106542
"650716148_NC_015711-gene_3139-gene_3236",650716148,3139,3236,3634976,3741271,106295
"650716148_NC_015711-gene_1-gene_45",650716148,1,45,0,42769,42769
"650716148_NC_015711-gene_1715-gene_1778",650716148,1715,1778,2003166,2075874,72708
"650716148_NC_015711-gene_6195-gene_6311",650716148,6195,6311,7431833,7590393,158560
"2631041829_Ga0081470_101-gene_874-gene_970",2631041829,874,970,1109040,1224964,115924
"2631041829_Ga0081470_101-gene_4501-gene_4706",2631041829,4501,4706,5804639,6067778,263139
"2631041829_Ga0081470_101-gene_3701-gene_3827",2631041829,3701,3827,4779125,4938773,159648
"2631041829_Ga0081470_101-gene_4803-gene_4920",2631041829,4803,4920,6180476,6324582,144106
"2631041750_Ga0081465_101-gene_1867-gene_1926",2631041750,1867,1926,2396611,2467466,70855
"2631041750_Ga0081465_101-gene_4134-gene_4229",2631041750,4134,4229,5349319,5453043,103724
"2631041750_Ga0081465_101-gene_2206-gene_2295",2631041750,2206,2295,2863666,2956141,92475
"637000606_NC_008312-gene_4076-gene_4144",637000606,4076,4144,6530028,6607557,77529
"637000606_NC_008312-gene_4711-gene_4800",637000606,4711,4800,7446415,7529688,83273
"637000606_NC_008312-gene_3386-gene_3484",637000606,3386,3484,5405655,5544111,138456
"637000606_NC_008312-gene_282-gene_299",637000606,282,299,470714,475205,4491
"637000606_NC_008312-gene_1114-gene_1208",637000606,1114,1208,1849434,1966962,117528
"637000606_NC_008312-gene_1286-gene_1382",637000606,1286,1382,2106565,2242912,136347
"637000467_NC_007645-gene_2880-gene_2978",637000467,2880,2978,3242227,3356516,114289
"637000467_NC_007645-gene_3387-gene_3472",637000467,3387,3472,3866134,3953635,87501
"637000467_NC_007645-gene_3236-gene_3309",637000467,3236,3309,3698631,3771374,72743
"637000467_NC_007645-gene_1894-gene_1932",637000467,1894,1932,2108647,2148592,39945
"637000467_NC_007645-gene_6362-gene_6418",637000467,6362,6418,7115730,7187335,71605
"637000467_NC_007645-gene_3508-gene_3564",637000467,3508,3564,4000967,4070997,70030
"637000233_NC_005027-gene_1561-gene_1633",637000233,1561,1633,2156629,2242457,85828
"637000233_NC_005027-gene_302-gene_526",637000233,302,526,424451,719343,294892
"637000233_NC_005027-gene_1-gene_28",637000233,1,28,0,30326,30326
"637000233_NC_005027-gene_1063-gene_1166",637000233,1063,1166,1480257,1634369,154112
"637000233_NC_005027-gene_4485-gene_4674",637000233,4485,4674,6125771,6376770,250999
"650716066_NC_015434-gene_2221-gene_2325",650716066,2221,2325,2371225,2477888,106663
"650716066_NC_015434-gene_5848-gene_5940",650716066,5848,5940,6415347,6531168,115821
"650716066_NC_015434-gene_577-gene_663",650716066,577,663,604169,696261,92092
"650716066_NC_015434-gene_2468-gene_2528",650716066,2468,2528,2657719,2707994,50275
"643692052_NC_012490-gene_2927-gene_2961",643692052,2927,2961,3072397,3099132,26735
"643692052_NC_012490-gene_2081-gene_2105",643692052,2081,2105,2239896,2260962,21066
"2508527215_MycrhN_Contig54_1-gene_2688-gene_2888",2508527215,2688,2888,2736318,2930611,194293
"2506535018_Aquba_Contig381-gene_2440-gene_2472",2506535018,2440,2472,2973148,3006634,33486
"2506535018_Aquba_Contig381-gene_2597-gene_2701",2506535018,2597,2701,3156320,3280248,123928
"2506535018_Aquba_Contig381-gene_3164-gene_3322",2506535018,3164,3322,3903568,4076128,172560
"2506535018_Aquba_Contig381-gene_4305-gene_4334",2506535018,4305,4334,5294383,5330093,35710
"2508501807_SacmaDRAFT_SMG_1-gene_4113-gene_4201",2508501807,4113,4201,4274351,4357716,83365
"2508501807_SacmaDRAFT_SMG_1-gene_13-gene_105",2508501807,13,105,15093,98516,83423
"2508501807_SacmaDRAFT_SMG_1-gene_5225-gene_5315",2508501807,5225,5315,5423726,5508304,84578
"2718228132_Ga0175156_11-gene_4007-gene_4032",2718228132,4007,4032,4352449,4372994,20545
"2506485008_Contig317-gene_2353-gene_2451",2506485008,2353,2451,2735207,2863376,128169
"2506485008_Contig317-gene_4705-gene_4804",2506485008,4705,4804,5443873,5558310,114437
"2506485008_Contig317-gene_2764-gene_2803",2506485008,2764,2803,3233670,3266691,33021
"2506485008_Contig317-gene_4573-gene_4589",2506485008,4573,4589,5300854,5314526,13672
"643692025_NC_012108-gene_1861-gene_1913",643692025,1861,1913,2163671,2214118,50447
"643692025_NC_012108-gene_4277-gene_4360",643692025,4277,4360,4977214,5063188,85974
"2562628756_CP007203-gene_1941-gene_1987",2562628756,1941,1987,2212462,2247794,35332
"643348578_NC_011566-gene_2857-gene_2879",643348578,2857,2879,3378505,3397747,19242
"637000158_NC_003910-gene_303-gene_340",637000158,303,340,350248,386593,36345
"637000158_NC_003910-gene_774-gene_798",637000158,774,798,887208,903063,15855
"651053104_CP002811-gene_172-gene_231",651053104,172,231,198334,258956,60622
"2512564983_OA238_c-gene_4446-gene_4545",2512564983,4446,4545,4129867,4217556,87689
"2524037964_FO203503-gene_2109-gene_2205",2524037964,2109,2205,2359594,2444611,85017
"2524037964_FO203503-gene_802-gene_896",2524037964,802,896,903466,977322,73856
"2524037964_FO203503-gene_3169-gene_3261",2524037964,3169,3261,3567366,3644024,76658
"2728434717_Ga0175483_11-gene_4310-gene_4351",2728434717,4310,4351,4389037,4425797,36760
"2728434717_Ga0175483_11-gene_825-gene_914",2728434717,825,914,816091,870732,54641
"646564612_NC_014041-gene_1185-gene_1278",646564612,1185,1278,1379931,1471440,91509
"646564612_NC_014041-gene_2481-gene_2503",646564612,2481,2503,2867548,2879201,11653
"646564612_NC_014041-gene_2016-gene_2093",646564612,2016,2093,2322772,2403406,80634
"646564612_NC_014041-gene_3681-gene_3771",646564612,3681,3771,4256332,4332618,76286
"646564612_NC_014041-gene_3035-gene_3139",646564612,3035,3139,3542923,3633871,90948
"637000514_NC_007912-gene_434-gene_493",637000514,434,493,518134,569197,51063
"637000514_NC_007912-gene_195-gene_294",637000514,195,294,239400,354055,114655
"637000514_NC_007912-gene_1863-gene_1898",637000514,1863,1898,2300286,2331113,30827
"637000514_NC_007912-gene_3099-gene_3115",637000514,3099,3115,3836046,3846111,10065
"637000514_NC_007912-gene_2363-gene_2423",637000514,2363,2423,2926621,2977451,50830
"2504762402_Contig38-gene_1644-gene_1736",2504762402,1644,1736,1852324,1940513,88189
"2504762402_Contig38-gene_2938-gene_2958",2504762402,2938,2958,3281385,3294342,12957
"2513256208_cola_cola-finished-ohne-overlap_screen_ace_1_1-gene_2288-gene_2356",2513256208,2288,2356,2662208,2736198,73990
"2513256208_cola_cola-finished-ohne-overlap_screen_ace_1_1-gene_2454-gene_2545",2513256208,2454,2545,2868388,2976331,107943
"2513256208_cola_cola-finished-ohne-overlap_screen_ace_1_1-gene_3309-gene_3408",2513256208,3309,3408,3925697,4026923,101226
"2513256208_cola_cola-finished-ohne-overlap_screen_ace_1_1-gene_725-gene_778",2513256208,725,778,894485,950216,55731
"2513256208_cola_cola-finished-ohne-overlap_screen_ace_1_1-gene_1839-gene_1994",2513256208,1839,1994,2125681,2290428,164747
"2513256208_cola_cola-finished-ohne-overlap_screen_ace_1_1-gene_3978-gene_4033",2513256208,3978,4033,4695011,4750386,55375
"2513256208_cola_cola-finished-ohne-overlap_screen_ace_1_1-gene_1353-gene_1442",2513256208,1353,1442,1596454,1680431,83977
"2504404809_AMB_SN2-gene_2113-gene_2134",2504404809,2113,2134,2440803,2457795,16992
"2504404809_AMB_SN2-gene_1185-gene_1245",2504404809,1185,1245,1394025,1449472,55447
"2504404809_AMB_SN2-gene_3425-gene_3487",2504404809,3425,3487,3959204,4005225,46021
"2521194451_CP003466-gene_2064-gene_2149",2521194451,2064,2149,2267143,2364899,97756
"2554309016_CP006643-gene_4315-gene_4347",2554309016,4315,4347,4319696,4356101,36405
"2526166614_K365DRAFT_scaffold00001_1-gene_2054-gene_2120",2526166614,2054,2120,2182760,2237229,54469
"2526166614_K365DRAFT_scaffold00001_1-gene_70-gene_135",2526166614,70,135,75641,121968,46327
"2526166614_K365DRAFT_scaffold00001_1-gene_2939-gene_3028",2526166614,2939,3028,3144735,3211291,66556
"2526166614_K365DRAFT_scaffold00001_1-gene_1819-gene_1840",2526166614,1819,1840,1908163,1923456,15293
"637000611_NC_008322-gene_1040-gene_1074",637000611,1040,1074,1173198,1208295,35097
"644736375_NC_012850-gene_709-gene_806",644736375,709,806,749181,826887,77706
"639633068_NC_008576-gene_2294-gene_2394",639633068,2294,2394,2753512,2908490,154978
"650716032_NC_015275-gene_1431-gene_1529",650716032,1431,1529,1602512,1688261,85749
"650716032_NC_015275-gene_71-gene_164",650716032,71,164,98034,210238,112204
"650716032_NC_015275-gene_3744-gene_3834",650716032,3744,3834,4059134,4155802,96668
"2596658995_LX98DRAFT_unitig_0_quiver_1-gene_923-gene_1018",2596658995,923,1018,1076589,1197072,120483
"2596658995_LX98DRAFT_unitig_0_quiver_1-gene_1318-gene_1455",2596658995,1318,1455,1542351,1709881,167530
"2596658995_LX98DRAFT_unitig_0_quiver_1-gene_2899-gene_2950",2596658995,2899,2950,3285114,3334405,49291
"2684693078_Ga0125241_11-gene_2209-gene_2246",2684693078,2209,2246,2643101,2670079,26978
"2506213072_Contig398-gene_2634-gene_2712",2506213072,2634,2712,2924335,2992093,67758
"2718228273_Ga0174870_11-gene_2263-gene_2327",2718228273,2263,2327,2653856,2708854,54998
"2718228273_Ga0174870_11-gene_1093-gene_1155",2718228273,1093,1155,1240194,1315681,75487
"639633099_NC_008711-gene_3189-gene_3244",639633099,3189,3244,3459694,3520334,60640
"2524031327_Shewanella-gene_142-gene_160",2524031327,142,160,150457,169260,18803
"2517487235_scaffold00006-gene_2672-gene_2731",2517487235,2672,2731,2699354,2761266,61912
"649633075_NC_014759-gene_238-gene_256",649633075,238,256,319148,354461,35313
"649633075_NC_014759-gene_3360-gene_3459",649633075,3360,3459,4022094,4150955,128861
"649633075_NC_014759-gene_1905-gene_1964",649633075,1905,1964,2330185,2392416,62231
"2521194441_CP003845-gene_2019-gene_2052",2521194441,2019,2052,2399118,2422966,23848
"2521194441_CP003845-gene_223-gene_281",2521194441,223,281,270810,323614,52804
"637000589_NC_008255-gene_477-gene_539",637000589,477,539,578980,654530,75550
"637000589_NC_008255-gene_2821-gene_2849",637000589,2821,2849,3365689,3400262,34573
"637000589_NC_008255-gene_1063-gene_1162",637000589,1063,1162,1288805,1398171,109366
"637000589_NC_008255-gene_2191-gene_2296",637000589,2191,2296,2656102,2756694,100592
"650377919_CP001978-gene_3109-gene_3128",650377919,3109,3128,3247572,3262409,14837
"650377919_CP001978-gene_69-gene_168",650377919,69,168,77394,163909,86515
"642555224_NC_011138-gene_3586-gene_3619",642555224,3586,3619,4042153,4065595,23442
"2597512639_Ga0036914_gi564132530_1-gene_3202-gene_3264",2597512639,3202,3264,3458987,3519090,60103
"2597512639_Ga0036914_gi564132530_1-gene_3097-gene_3192",2597512639,3097,3192,3356791,3445787,88996
"2597512639_Ga0036914_gi564132530_1-gene_1827-gene_1849",2597512639,1827,1849,1969428,1989439,20011
"2721801484_Ga0175998_12-gene_2983-gene_3022",2721801484,2983,3022,3567570,3606413,38843
"2721801484_Ga0175998_12-gene_465-gene_503",2721801484,465,503,549093,572064,22971
"2512571803_NC_016940-gene_112-gene_205",2512571803,112,205,135529,267910,132381
"2512571803_NC_016940-gene_435-gene_534",2512571803,435,534,588654,697810,109156
"2512571803_NC_016940-gene_3304-gene_3403",2512571803,3304,3403,4233049,4340705,107656
"2512571803_NC_016940-gene_3132-gene_3227",2512571803,3132,3227,3993123,4124066,130943
"2512571803_NC_016940-gene_2702-gene_2913",2512571803,2702,2913,3463473,3717888,254415
"2512571803_NC_016940-gene_2600-gene_2699",2512571803,2600,2699,3333163,3460800,127637
"2512571803_NC_016940-gene_270-gene_366",2512571803,270,366,350324,502287,151963
"2721800935_Ga0175699_12-gene_1265-gene_1361",2721800935,1265,1361,1329404,1408390,78986
"2721800935_Ga0175699_12-gene_3788-gene_3875",2721800935,3788,3875,3888197,3971204,83007
"2721800935_Ga0175699_12-gene_4069-gene_4168",2721800935,4069,4168,4182293,4277394,95101
"637000507_NC_007802-gene_3601-gene_3699",637000507,3601,3699,3578629,3691945,113316
"2519117607_CP003746-gene_2821-gene_2874",2519117607,2821,2874,3043185,3079999,36814
"2521191523_Phaar_neu_scaffold_2516677464_1-gene_4099-gene_4114",2521191523,4099,4114,4207554,4215395,7841
"2721800962_Ga0175322_11-gene_2232-gene_2293",2721800962,2232,2293,2563519,2631491,67972
"2687454401_Ga0133388_11-gene_397-gene_493",2687454401,397,493,408818,495851,87033
"2687454401_Ga0133388_11-gene_3416-gene_3469",2687454401,3416,3469,3582641,3653324,70683
"2667542047_Ga0105927_11-gene_397-gene_496",2667542047,397,496,408817,498133,89316
"2667542047_Ga0105927_11-gene_3412-gene_3470",2667542047,3412,3470,3574794,3658705,83911
"2622780072_scf7180000000004-gene_1460-gene_1474",2622780072,1460,1474,1722181,1727364,5183
"2622780072_scf7180000000004-gene_3486-gene_3530",2622780072,3486,3530,4079144,4116850,37706
"2558913391_P176DRAFT_scf7180000000002_quiver_dupTrim_6579_1-gene_3514-gene_3571",2558913391,3514,3571,4077182,4106062,28880
"2558913391_P176DRAFT_scf7180000000002_quiver_dupTrim_6579_1-gene_1705-gene_1720",2558913391,1705,1720,1998637,2011151,12514
"2558913391_P176DRAFT_scf7180000000002_quiver_dupTrim_6579_1-gene_211-gene_301",2558913391,211,301,236523,342458,105935
"2718228355_Ga0175168_11-gene_1545-gene_1628",2718228355,1545,1628,1786061,1859443,73382
"646564576_NC_013960-gene_280-gene_298",646564576,280,298,285409,302089,16680
"2506842939_Thimo_Contig50-gene_758-gene_855",2506842939,758,855,841051,942434,101383
"2506842939_Thimo_Contig50-gene_2222-gene_2294",2506842939,2222,2294,2495885,2567772,71887
"2512205695_CP002987-gene_1133-gene_1210",2512205695,1133,1210,1271969,1343155,71186
"2508526980_Oweho_Contig158_1-gene_3098-gene_3162",2508526980,3098,3162,3571552,3632697,61145
"2558913389_P161DRAFT_scf7180000000002_quiver_dupTrim_7254_1-gene_1327-gene_1405",2558913389,1327,1405,1521192,1604573,83381
"2558913389_P161DRAFT_scf7180000000002_quiver_dupTrim_7254_1-gene_2929-gene_2945",2558913389,2929,2945,3398063,3408189,10126
"2558913389_P161DRAFT_scf7180000000002_quiver_dupTrim_7254_1-gene_719-gene_775",2558913389,719,775,846805,905434,58629
"2540348206_FO203363-gene_1760-gene_1836",2540348206,1760,1836,1925568,1997432,71864
"2667542034_Ga0114080_11-gene_3634-gene_3708",2667542034,3634,3708,3103216,3163620,60404
"2667542034_Ga0114080_11-gene_3001-gene_3089",2667542034,3001,3089,2559212,2637072,77860
"647533596_NZ_DS995276-gene_101-gene_177",647533596,101,177,89662,148538,58876
"2721801272_Ga0176028_11-gene_1468-gene_1515",2721801272,1468,1515,1744424,1799780,55356
"2721801272_Ga0176028_11-gene_2385-gene_2442",2721801272,2385,2442,2808078,2863988,55910
"2721801272_Ga0176028_11-gene_545-gene_627",2721801272,545,627,622299,702120,79821
"2721801272_Ga0176028_11-gene_2650-gene_2729",2721801272,2650,2729,3093958,3165915,71957
"2509292657_JoomaDRAFT_JMA_2-gene_1256-gene_1277",2509292657,1256,1277,1408691,1426889,18198
"2509292657_JoomaDRAFT_JMA_2-gene_188-gene_250",2509292657,188,250,207633,267388,59755
"2540348160_CP001397-gene_2517-gene_2670",2540348160,2517,2670,2907405,3068567,161162
"2540348160_CP001397-gene_208-gene_273",2540348160,208,273,269200,338223,69023
"2540348160_CP001397-gene_2236-gene_2319",2540348160,2236,2319,2565003,2657973,92970
"2540348160_CP001397-gene_2886-gene_3002",2540348160,2886,3002,3307119,3434800,127681
"2540348160_CP001397-gene_592-gene_685",2540348160,592,685,678526,760688,82162
"647533601_NZ_DS995281-gene_3189-gene_3244",647533601,3189,3244,3275278,3340452,65174
"650716068_NC_015458-gene_209-gene_304",650716068,209,304,243624,372854,129230
"2503755728_Ddes_Contig54-gene_2498-gene_2537",2503755728,2498,2537,2718908,2774854,55946
"641522729_NC_010674-gene_3380-gene_3466",641522729,3380,3466,3656629,3762077,105448
"641522729_NC_010674-gene_1541-gene_1634",641522729,1541,1634,1662386,1763223,100837
"639633066_NC_008571-gene_2377-gene_2437",639633066,2377,2437,2682923,2745595,62672
"639633066_NC_008571-gene_796-gene_879",639633066,796,879,945885,1027230,81345
"2556981731_CP006939-gene_599-gene_686",2556981731,599,686,681465,764372,82907
"2690318780_Ga0045920_11-gene_1547-gene_1642",2690318780,1547,1642,1663315,1764156,100841
"2667536837_Ga0104699_11-gene_7-gene_79",2667536837,7,79,6118,89812,83694
"2667536837_Ga0104699_11-gene_1934-gene_1962",2667536837,1934,1962,2084320,2114365,30045
"646564593_NC_014008-gene_23-gene_130",646564593,23,130,24386,170619,146233
"646564593_NC_014008-gene_1988-gene_2006",646564593,1988,2006,2472434,2528606,56172
"646564593_NC_014008-gene_540-gene_562",646564593,540,562,723636,738849,15213
"646564593_NC_014008-gene_3018-gene_3039",646564593,3018,3039,3694872,3709458,14586
"646564593_NC_014008-gene_266-gene_307",646564593,266,307,357993,383617,25624
"2540348203_FO203427-gene_1208-gene_1305",2540348203,1208,1305,1332685,1409566,76881
"647533454_NZ_DS989898-gene_3055-gene_3133",647533454,3055,3133,3135125,3195236,60111
"647533454_NZ_DS989898-gene_1565-gene_1654",647533454,1565,1654,1607913,1703106,95193
"2596648949_LY87DRAFT_unitig_0_quiver_1-gene_3027-gene_3104",2596648949,3027,3104,3425272,3523603,98331
"2596648949_LY87DRAFT_unitig_0_quiver_1-gene_1987-gene_2095",2596648949,1987,2095,2237570,2351633,114063
"2511051433_CP002901-gene_2025-gene_2117",2511051433,2025,2117,1986387,2061217,74830
"2511051433_CP002901-gene_443-gene_538",2511051433,443,538,455482,537992,82510
"2511051433_CP002901-gene_2541-gene_2686",2511051433,2541,2686,2461485,2573542,112057
"2511051433_CP002901-gene_2995-gene_3110",2511051433,2995,3110,2887013,2970878,83865
"646311903_NC_013222-gene_2003-gene_2051",646311903,2003,2051,2310398,2350122,39724
"646311903_NC_013222-gene_201-gene_298",646311903,201,298,250985,348187,97202
"2724812732_K10K4_chromosome1-gene_1758-gene_1857",2724812732,1758,1857,1951163,2063015,111852
"2724812732_K10K4_chromosome1-gene_1339-gene_1363",2724812732,1339,1363,1481535,1498667,17132
"637000420_NC_007484-gene_386-gene_478",637000420,386,478,423923,494964,71041
"2724812413_K04M3_chromosome1-gene_1784-gene_1883",2724812413,1784,1883,1970202,2082054,111852
"2724812413_K04M3_chromosome1-gene_1373-gene_1397",2724812413,1373,1397,1508151,1525283,17132
"2724812419_K05K4_chromosome1-gene_1785-gene_1884",2724812419,1785,1884,1967607,2079458,111851
"2724812419_K05K4_chromosome1-gene_1361-gene_1385",2724812419,1361,1385,1497978,1515110,17132
"2724812408_K04M1_chromosome1-gene_1370-gene_1394",2724812408,1370,1394,1503811,1520943,17132
"2724812408_K04M1_chromosome1-gene_1777-gene_1877",2724812408,1777,1877,1965862,2077714,111852
"2724812723_K06K5_chromosome1-gene_1777-gene_1876",2724812723,1777,1876,1965338,2077190,111852
"2724812723_K06K5_chromosome1-gene_1371-gene_1395",2724812723,1371,1395,1503287,1520419,17132
"2724812416_K04M5_chromosome1-gene_1765-gene_1865",2724812416,1765,1865,1963657,2075509,111852
"2724812416_K04M5_chromosome1-gene_1337-gene_1361",2724812416,1337,1361,1481536,1498668,17132
"2724812406_K01M1_chromosome1-gene_1363-gene_1387",2724812406,1363,1387,1500281,1517413,17132
"2724812406_K01M1_chromosome1-gene_1769-gene_1868",2724812406,1769,1868,1962332,2074184,111852
"2724812734_K08M3_chromosome1-gene_1770-gene_1870",2724812734,1770,1870,1960873,2072725,111852
"2724812734_K08M3_chromosome1-gene_1360-gene_1384",2724812734,1360,1384,1498822,1515954,17132
"2724812731_K09K1_contig000002-gene_192-gene_216",2724812731,192,216,214660,231792,17132
"2724812731_K09K1_contig000002-gene_2779-gene_2877",2724812731,2779,2877,3110919,3219335,108416
"2718228555_Ga0175862_11-gene_817-gene_837",2718228555,817,837,810165,828036,17871
"2718227896_Ga0175494_11-gene_2145-gene_2191",2718227896,2145,2191,2588424,2628299,39875
"637000619_NC_008347-gene_509-gene_603",637000619,509,603,589932,676350,86418
"637000559_NC_008048-gene_50-gene_96",637000559,50,96,49017,95898,46881
"650716118_NC_015638-gene_2245-gene_2282",650716118,2245,2282,2506804,2543593,36789
"650716118_NC_015638-gene_2872-gene_2926",650716118,2872,2926,3187557,3237634,50077
"2549075848_RCA23c-gene_1269-gene_1366",2549075848,1269,1366,1323803,1426939,103136
"2504643033_SYNPCC8807DRAFT_8807_chromosome-gene_80-gene_98",2504643033,80,98,94011,104165,10154
"2504643047_SYNPCC73109DRAFT_73109_chromosome-gene_1788-gene_1815",2504643047,1788,1815,2000010,2028458,28448
"2504643047_SYNPCC73109DRAFT_73109_chromosome-gene_1921-gene_1942",2504643047,1921,1942,2155308,2167710,12402
"646311952_NC_013456-gene_1539-gene_1644",646311952,1539,1644,1746774,1849178,102404
"2627853750_Ga0079189_11-gene_1958-gene_2025",2627853750,1958,2025,2052877,2118210,65333
"2627853750_Ga0079189_11-gene_1700-gene_1792",2627853750,1700,1792,1771914,1871335,99421
"2718228224_Ga0176053_11-gene_1461-gene_1516",2718228224,1461,1516,1451904,1497385,45481
"2718228346_Ga0175161_11-gene_1608-gene_1702",2718228346,1608,1702,1845504,1924416,78912
"2721801511_Ga0175657_12-gene_323-gene_351",2721801511,323,351,302342,331688,29346
"2663809665_Ga0114161_11-gene_1830-gene_1902",2663809665,1830,1902,2068306,2142360,74054
"2663809665_Ga0114161_11-gene_533-gene_630",2663809665,533,630,606913,713441,106528
"2526170607_CA2559_HTCC2559_1-gene_53-gene_93",2526170607,53,93,85933,123820,37887
"648028061_NC_014414-gene_1047-gene_1134",648028061,1047,1134,1104336,1203084,98748
"648028061_NC_014414-gene_2294-gene_2320",648028061,2294,2320,2476066,2504856,28790
"2622780069_CP011373-gene_56-gene_100",2622780069,56,100,47110,84946,37836
"2622780069_CP011373-gene_873-gene_915",2622780069,873,915,939171,981858,42687
"647535429_NZ_GG704599-gene_220-gene_250",647535429,220,250,218448,252050,33602
"647533516_NZ_DS990556-gene_2410-gene_2507",647533516,2410,2507,2403035,2503079,100044
"2507267694_KS100_Contig_1-gene_2360-gene_2459",2507267694,2360,2459,2275983,2360575,84592
"2507267694_KS100_Contig_1-gene_1083-gene_1181",2507267694,1083,1181,1070014,1156405,86391
"2507267694_KS100_Contig_1-gene_1651-gene_1719",2507267694,1651,1719,1642710,1699735,57025
"2507267694_KS100_Contig_1-gene_618-gene_665",2507267694,618,665,646060,686458,40398
"2507267694_KS100_Contig_1-gene_1550-gene_1565",2507267694,1550,1565,1551271,1561179,9908
"2507267694_KS100_Contig_1-gene_1733-gene_1831",2507267694,1733,1831,1708012,1777854,69842
"646564595_NC_014010-gene_1721-gene_1753",646564595,1721,1753,1849158,1880413,31255
"646564595_NC_014010-gene_1287-gene_1326",646564595,1287,1326,1389905,1428650,38745
"2513265731_NZ_AGIF02000001-gene_1885-gene_1902",2513265731,1885,1902,2086258,2097722,11464
"642555184_NC_010831-gene_1829-gene_1927",642555184,1829,1927,2039371,2133384,94013
"2507281848_Syn8016_Contig50_1-gene_1018-gene_1113",2507281848,1018,1113,949918,1041210,91292
"2507281848_Syn8016_Contig50_1-gene_125-gene_224",2507281848,125,224,108021,183191,75170
"2507281848_Syn8016_Contig50_1-gene_30-gene_80",2507281848,30,80,25968,61332,35364
"2507281848_Syn8016_Contig50_1-gene_2667-gene_2690",2507281848,2667,2690,2586837,2600341,13504
"2507281848_Syn8016_Contig50_1-gene_297-gene_400",2507281848,297,400,248809,335127,86318
"2507281848_Syn8016_Contig50_1-gene_1207-gene_1265",2507281848,1207,1265,1136273,1181506,45233
"2507281848_Syn8016_Contig50_1-gene_491-gene_593",2507281848,491,593,419656,523844,104188
"2507281848_Syn8016_Contig50_1-gene_1666-gene_1762",2507281848,1666,1762,1585039,1675991,90952
"2507281848_Syn8016_Contig50_1-gene_2305-gene_2399",2507281848,2305,2399,2239804,2334181,94377
"640069312_NC_008820-gene_244-gene_322",640069312,244,322,284900,378422,93522
"640069312_NC_008820-gene_847-gene_920",640069312,847,920,918930,995378,76448
"640069312_NC_008820-gene_936-gene_1035",640069312,936,1035,1013875,1109970,96095
"2571071633_BS76DRAFT_scf7180000000002_quiver_dupTrim_10022_1-gene_2225-gene_2249",2571071633,2225,2249,2353746,2378727,24981
"2509602057_Halha_Contig26_1-gene_1232-gene_1253",2509602057,1232,1253,1274933,1288280,13347
"2509602057_Halha_Contig26_1-gene_1873-gene_1921",2509602057,1873,1921,1953601,1984022,30421
"650716048_NC_015391-gene_65-gene_163",650716048,65,163,71999,152397,80398
"650716048_NC_015391-gene_863-gene_897",650716048,863,897,910312,934565,24253
"637000608_NC_008319-gene_1551-gene_1652",637000608,1551,1652,1573811,1656493,82682
"637000608_NC_008319-gene_2428-gene_2526",637000608,2428,2526,2417975,2517479,99504
"637000608_NC_008319-gene_939-gene_1019",637000608,939,1019,940692,1028499,87807
"637000608_NC_008319-gene_558-gene_657",637000608,558,657,578864,668318,89454
"637000608_NC_008319-gene_2088-gene_2162",637000608,2088,2162,2075805,2144903,69098
"637000608_NC_008319-gene_716-gene_809",637000608,716,809,729363,808899,79536
"2517287732_B044DRAFT_scaffold1_1-gene_77-gene_121",2517287732,77,121,78702,110555,31853
"2507267692_KS49_KORDI_49_1-gene_1737-gene_1791",2507267692,1737,1791,1734359,1774769,40410
"2507267692_KS49_KORDI_49_1-gene_2073-gene_2199",2507267692,2073,2199,2062884,2197794,134910
"2507267692_KS49_KORDI_49_1-gene_756-gene_843",2507267692,756,843,789551,858847,69296
"2507267692_KS49_KORDI_49_1-gene_1565-gene_1659",2507267692,1565,1659,1561955,1648631,86676
"2507267692_KS49_KORDI_49_1-gene_1029-gene_1136",2507267692,1029,1136,1085777,1166620,80843
"2507267692_KS49_KORDI_49_1-gene_1148-gene_1217",2507267692,1148,1217,1174997,1221733,46736
"2576887216_P163DRAFT_scf7180000000039_quiver_5-gene_2212-gene_2298",2576887216,2212,2298,2444487,2546222,101735
"2576887216_P163DRAFT_scf7180000000039_quiver_5-gene_969-gene_1044",2576887216,969,1044,1095440,1167980,72540
"2507267693_KS52_KORDI_52_1-gene_994-gene_1073",2507267693,994,1073,950531,1025271,74740
"2507267693_KS52_KORDI_52_1-gene_1479-gene_1578",2507267693,1479,1578,1402028,1465532,63504
"2507267693_KS52_KORDI_52_1-gene_1871-gene_1934",2507267693,1871,1934,1737091,1793207,56116
"2507267693_KS52_KORDI_52_1-gene_2069-gene_2111",2507267693,2069,2111,1935128,1973421,38293
"2507267693_KS52_KORDI_52_1-gene_1245-gene_1309",2507267693,1245,1309,1188696,1243596,54900
"2507267693_KS52_KORDI_52_1-gene_763-gene_810",2507267693,763,810,720704,778258,57554
"2507267693_KS52_KORDI_52_1-gene_513-gene_541",2507267693,513,541,506126,526034,19908
"2507267693_KS52_KORDI_52_1-gene_1663-gene_1755",2507267693,1663,1755,1544049,1618992,74943
"640753031_NC_009663-gene_2078-gene_2108",640753031,2078,2108,2086610,2113648,27038
"640753031_NC_009663-gene_717-gene_815",640753031,717,815,721446,807318,85872
"2509292655_ThesiDRAFT_TSF_1-gene_932-gene_1033",2509292655,932,1033,878124,968801,90677
"2718228072_Ga0174827_11-gene_885-gene_922",2718228072,885,922,951004,986152,35148
"2718228072_Ga0174827_11-gene_1264-gene_1293",2718228072,1264,1293,1337568,1351588,14020
"637000441_NC_007516-gene_1976-gene_2039",637000441,1976,2039,1708133,1756052,47919
"637000441_NC_007516-gene_969-gene_1002",637000441,969,1002,896600,920504,23904
"637000441_NC_007516-gene_2325-gene_2419",637000441,2325,2419,2030512,2114051,83539
"637000441_NC_007516-gene_1283-gene_1297",637000441,1283,1297,1152783,1159946,7163
"637000441_NC_007516-gene_1086-gene_1155",637000441,1086,1155,992705,1036199,43494
"637000441_NC_007516-gene_1872-gene_1892",637000441,1872,1892,1623201,1638284,15083
"637000441_NC_007516-gene_1507-gene_1643",637000441,1507,1643,1364598,1447850,83252
"637000441_NC_007516-gene_2596-gene_2707",637000441,2596,2707,2284116,2395236,111120
"637000441_NC_007516-gene_1656-gene_1755",637000441,1656,1755,1461818,1544433,82615
"638366418_NZ_AANA01000001-gene_1437-gene_1454",638366418,1437,1454,1642472,1659911,17439
